1443,1204,2,resign,black,239,B02,Alekhine Defense
1293,2263,30,resign,black,970,B02,Alekhine Defense
1178,1132,80,resign,black,46,B02,Alekhine Defense
1037,1004,72,time,black,33,B02,Alekhine Defense
1071,1118,98,time,black,47,B02,Alekhine Defense
1238,1500,102,mate,black,262,B02,Alekhine Defense
1673,1603,82,time,black,70,B02,Alekhine Defense
1278,1220,54,resign,black,58,B02,Alekhine Defense
1350,1201,118,mate,black,149,B03,Alekhine Defense #2
1586,2133,34,mate,black,547,B03,Alekhine Defense: Balogh Variation
1500,1758,62,mate,black,258,B03,Alekhine Defense: Four Pawns Attack
1693,2287,80,mate,black,594,B02,Alekhine Defense: John Tracy Gambit
1603,1429,68,mate,black,174,B02,Alekhine Defense: Krejcik Variation
1268,1142,48,resign,black,126,B02,Alekhine Defense: Maroczy Variation
1009,1513,54,resign,black,504,B02,Alekhine Defense: Maroczy Variation
1027,1509,12,resign,black,482,B02,Alekhine Defense: Maroczy Variation
1509,1487,62,mate,black,22,B05,Alekhine Defense: Modern Variation |  Main Line
1083,1165,56,mate,black,82,B02,Alekhine Defense: Mokele Mbembe
1205,1199,10,resign,black,6,B02,Alekhine Defense: Normal Variation
1094,1427,58,mate,black,333,B02,Alekhine Defense: Normal Variation
1620,1909,44,resign,black,289,B02,Alekhine Defense: Normal Variation
1264,1477,24,mate,black,213,B02,Alekhine Defense: Normal Variation
1212,1221,72,mate,black,9,B02,Alekhine Defense: Saemisch Attack
1560,1580,38,time,black,20,B02,Alekhine Defense: Scandinavian Variation
1414,1594,82,resign,black,180,B02,Alekhine Defense: Scandinavian Variation
1575,1844,122,mate,black,269,B02,Alekhine Defense: Scandinavian Variation
1278,1280,66,time,black,2,B02,Alekhine Defense: Scandinavian Variation
1732,1785,90,mate,black,53,B02,Alekhine Defense: Scandinavian Variation
1334,1345,26,time,black,11,B02,Alekhine Defense: Scandinavian Variation
1364,1033,126,mate,black,331,B02,Alekhine Defense: Scandinavian Variation
1501,1640,122,mate,black,139,B02,Alekhine Defense: Steiner Variation
1422,1210,32,resign,black,212,B02,Alekhine Defense: Two Pawn Attack
1295,1308,40,mate,black,13,B02,Alekhine Defense: Two Pawn Attack
1228,1266,37,resign,black,38,B02,Alekhine Defense: Two Pawn Attack |  Lasker Variation
1234,1096,22,resign,black,138,E00,Amar Opening
1342,1632,20,mate,black,290,E00,Amar Opening
1500,1725,28,mate,black,225,A00,Anderssen Opening
1696,1563,70,mate,black,133,A00,Anderssen Opening
1187,1265,56,mate,black,78,B00,Barnes Defense
1590,1471,110,mate,black,119,B00,Barnes Defense
1411,1446,40,resign,black,35,B00,Barnes Defense
2420,2404,50,resign,black,16,A58,Benko Gambit Accepted |  Fully Accepted Variation
2052,2287,72,resign,black,235,A59,Benko Gambit Accepted |  Yugoslav |  without 7...Bxf1
1964,1813,38,resign,black,151,A57,Benko Gambit Declined |  Main Line
1672,1890,80,resign,black,218,A56,Benoni Defense
1857,2176,52,time,black,319,A56,Benoni Defense
2179,2189,76,time,black,10,A56,Benoni Defense
1725,1457,72,resign,black,268,A56,Benoni Defense
1500,1432,10,mate,black,68,A43,Benoni Defense: Benoni Gambit Accepted
1745,1683,30,resign,black,62,A43,Benoni Defense: Benoni Gambit Accepted
1693,1591,73,resign,black,102,A43,Benoni Defense: Benoni Gambit |  Schlenker Defense
1450,1303,38,resign,black,147,A73,Benoni Defense: Classical Variation |  Main Line
2035,1961,92,mate,black,74,A56,Benoni Defense: Czech Benoni Defense
1881,1518,84,resign,black,363,A56,Benoni Defense: Czech Benoni Defense
1735,1794,56,mate,black,59,A56,Benoni Defense: Czech Benoni Defense
1739,1840,54,mate,black,101,A65,Benoni Defense: King's Pawn Line
1585,1820,38,resign,black,235,A60,Benoni Defense: Modern Variation
1309,1317,23,resign,black,8,A43,Benoni Defense: Old Benoni
1580,1617,36,resign,black,37,A03,Bird Opening
1527,1861,4,mate,black,334,A02,Bird Opening
1527,1882,4,mate,black,355,A02,Bird Opening
1533,1897,4,mate,black,364,A02,Bird Opening
1552,1887,4,mate,black,335,A02,Bird Opening
1711,1766,56,time,black,55,A02,Bird Opening
1303,1475,10,mate,black,172,A02,Bird Opening
1466,1405,60,mate,black,61,A02,Bird Opening
1487,2008,98,mate,black,521,A02,Bird Opening
1670,1345,2,resign,black,325,A02,Bird Opening
1631,1531,77,resign,black,100,A02,Bird Opening
1571,1577,70,resign,black,6,A03,Bird Opening: Dutch Variation
1692,1699,60,resign,black,7,A03,Bird Opening: Dutch Variation
1695,1834,70,resign,black,139,A03,Bird Opening: Dutch Variation
1729,1894,38,resign,black,165,A03,Bird Opening: Dutch Variation
1514,1560,46,mate,black,46,A03,Bird Opening: Dutch Variation
1535,1620,80,resign,black,85,A03,Bird Opening: Dutch Variation
1996,2193,4,resign,black,197,A03,Bird Opening: Dutch Variation
1915,1807,66,mate,black,108,A03,Bird Opening: Dutch Variation
1445,1210,76,mate,black,235,A03,Bird Opening: Dutch Variation
1444,1491,40,mate,black,47,A03,Bird Opening: Dutch Variation
1441,1807,108,mate,black,366,A03,Bird Opening: Dutch Variation
1478,1488,58,mate,black,10,A03,Bird Opening: Dutch Variation
1480,1607,116,resign,black,127,A03,Bird Opening: Dutch Variation
1783,1797,38,mate,black,14,A02,Bird Opening: From's Gambit
1386,1640,38,mate,black,254,A02,Bird Opening: From's Gambit
1821,2211,16,mate,black,390,A02,Bird Opening: From's Gambit
946,1545,12,resign,black,599,A02,Bird Opening: From's Gambit
1634,1603,92,resign,black,31,C23,Bishop's Opening
1229,1160,22,resign,black,69,C23,Bishop's Opening
1676,1637,80,resign,black,39,C23,Bishop's Opening
1369,1413,58,mate,black,44,C23,Bishop's Opening
1331,1434,84,mate,black,103,C23,Bishop's Opening
1441,1338,41,resign,black,103,C23,Bishop's Opening
1163,1985,22,mate,black,822,C23,Bishop's Opening
1158,1383,78,resign,black,225,C23,Bishop's Opening
1158,1191,62,mate,black,33,C23,Bishop's Opening
1161,1200,60,mate,black,39,C23,Bishop's Opening
1932,1951,68,resign,black,19,C23,Bishop's Opening
1929,1955,126,resign,black,26,C23,Bishop's Opening
1153,1370,14,resign,black,217,C23,Bishop's Opening
1155,1170,44,resign,black,15,C23,Bishop's Opening
1164,1616,18,resign,black,452,C23,Bishop's Opening
1209,1320,76,mate,black,111,C23,Bishop's Opening
1013,1206,98,time,black,193,C23,Bishop's Opening
1575,1640,10,resign,black,65,C23,Bishop's Opening
1422,1336,14,resign,black,86,C23,Bishop's Opening
1529,1729,28,resign,black,200,C23,Bishop's Opening
1447,1485,126,resign,black,38,C23,Bishop's Opening
1472,1468,52,mate,black,4,C23,Bishop's Opening
1401,1429,30,resign,black,28,C23,Bishop's Opening
1579,1760,92,resign,black,181,C24,Bishop's Opening: Berlin Defense
1696,1725,80,time,black,29,C24,Bishop's Opening: Berlin Defense
1718,1649,42,resign,black,69,C24,Bishop's Opening: Berlin Defense
1802,2251,68,resign,black,449,C24,Bishop's Opening: Berlin Defense
1528,1458,96,resign,black,70,C24,Bishop's Opening: Berlin Defense
1504,1531,74,resign,black,27,C24,Bishop's Opening: Berlin Defense
1635,1595,40,resign,black,40,C24,Bishop's Opening: Berlin Defense
1697,1566,70,resign,black,131,C24,Bishop's Opening: Berlin Defense
1061,1297,27,resign,black,236,C20,Bishop's Opening: Boi Variation
1629,1517,26,mate,black,112,C20,Bishop's Opening: Boi Variation
1215,1703,106,mate,black,488,C20,Bishop's Opening: Boi Variation
1672,1988,70,mate,black,316,C20,Bishop's Opening: Boi Variation
1240,1272,64,resign,black,32,C20,Bishop's Opening: Boi Variation
1522,1456,28,mate,black,66,C20,Bishop's Opening: Boi Variation
1418,1482,20,mate,black,64,C20,Bishop's Opening: Boi Variation
1406,1416,50,resign,black,10,C23,Bishop's Opening: Calabrese Countergambit
1054,1384,108,mate,black,330,C23,Bishop's Opening: Khan Gambit
1640,1456,32,resign,black,184,C23,Bishop's Opening: Khan Gambit
1224,1763,32,mate,black,539,C23,Bishop's Opening: Philidor Counterattack
1756,1756,40,mate,black,0,C24,Bishop's Opening: Ponziani Gambit
1785,1432,50,resign,black,353,C24,Bishop's Opening: Ponziani Gambit
1564,1389,92,mate,black,175,C24,Bishop's Opening: Ponziani Gambit
1787,2258,56,resign,black,471,C28,Bishop's Opening: Vienna Hybrid
1804,1869,104,time,black,65,C28,Bishop's Opening: Vienna Hybrid
989,791,74,resign,black,198,D00,Blackmar-Diemer Gambit
1324,1215,26,resign,black,109,D00,Blackmar-Diemer Gambit
1500,1520,20,resign,black,20,D00,Blackmar-Diemer Gambit
1425,1525,4,resign,black,100,D00,Blackmar-Diemer Gambit
1519,1482,63,resign,black,37,D00,Blackmar-Diemer Gambit
1576,1352,43,resign,black,224,D00,Blackmar-Diemer Gambit
1583,1496,132,mate,black,87,D00,Blackmar-Diemer Gambit
1556,1550,64,resign,black,6,D00,Blackmar-Diemer Gambit
1141,1358,4,resign,black,217,D00,Blackmar-Diemer Gambit
1461,1402,36,resign,black,59,D00,Blackmar-Diemer Gambit Declined |  Lamb Defense
984,1378,76,resign,black,394,D00,Blackmar-Diemer Gambit: Gedult Gambit
1499,1449,70,resign,black,50,D00,Blackmar-Diemer Gambit: Gedult Gambit
1221,1168,50,mate,black,53,D00,Blackmar-Diemer Gambit: Gedult Gambit
1539,1533,52,mate,black,6,D00,Blackmar-Diemer Gambit: Netherlands Variation
1229,1517,86,time,black,288,D00,Blackmar-Diemer Gambit: Ryder Gambit
1828,1948,94,time,black,120,D00,Blackmar-Diemer Gambit: Teichmann Variation
1084,1402,26,resign,black,318,D00,Blackmar-Diemer Gambit: Vienna Variation
1835,1865,158,mate,black,30,E10,Blumenfeld Countergambit #2
1278,1500,8,resign,black,222,B00,Borg Defense
1471,1488,58,mate,black,17,B00,Borg Defense
1767,2050,86,resign,black,283,A52,Budapest Defense
2149,1933,60,resign,black,216,A52,Budapest Defense: Adler Variation
1645,1806,70,resign,black,161,A52,Budapest Defense: Adler Variation
1708,1864,92,resign,black,156,A52,Budapest Defense: Adler Variation
1873,1574,16,mate,black,299,A52,Budapest Defense: Adler Variation
1611,1560,16,mate,black,51,A52,Budapest Defense: Adler Variation
1729,1886,20,resign,black,157,A52,Budapest Defense: Adler Variation
1511,1680,38,resign,black,169,A52,Budapest Defense: Adler Variation
1860,1886,50,mate,black,26,A52,Budapest Defense: Adler Variation
1811,1753,16,mate,black,58,A52,Budapest Defense: Adler Variation
1972,1952,74,mate,black,20,A52,Budapest Defense: Rubinstein Variation
1545,1554,44,resign,black,9,B15,Caro-Kann Defense
1236,1941,19,resign,black,705,B10,Caro-Kann Defense
1377,1340,44,mate,black,37,B10,Caro-Kann Defense
1375,1529,100,resign,black,154,B12,Caro-Kann Defense
1472,1498,51,resign,black,26,B12,Caro-Kann Defense
1431,1376,22,resign,black,55,B10,Caro-Kann Defense
1154,1332,118,mate,black,178,B10,Caro-Kann Defense
1097,1902,68,mate,black,805,B10,Caro-Kann Defense
1272,1169,40,time,black,103,B10,Caro-Kann Defense
1500,1401,23,resign,black,99,B10,Caro-Kann Defense
1234,1235,60,mate,black,1,B10,Caro-Kann Defense
1291,1301,60,mate,black,10,B10,Caro-Kann Defense
1346,1276,96,time,black,70,B10,Caro-Kann Defense
1830,1694,84,resign,black,136,B10,Caro-Kann Defense
1154,1240,58,mate,black,86,B15,Caro-Kann Defense
1645,1649,62,resign,black,4,B10,Caro-Kann Defense
1353,1661,46,mate,black,308,B10,Caro-Kann Defense
1359,2109,44,mate,black,750,B10,Caro-Kann Defense
1389,1561,64,mate,black,172,B10,Caro-Kann Defense
1478,1668,188,mate,black,190,B11,Caro-Kann Defense
1298,1347,45,resign,black,49,B15,Caro-Kann Defense
1678,1395,112,mate,black,283,B10,Caro-Kann Defense
1549,1504,28,resign,black,45,B11,Caro-Kann Defense
1185,1542,86,mate,black,357,B10,Caro-Kann Defense
1649,1445,52,resign,black,204,B10,Caro-Kann Defense
1544,1558,88,mate,black,14,B11,Caro-Kann Defense
1526,1640,58,mate,black,114,B11,Caro-Kann Defense
1065,1344,70,resign,black,279,B11,Caro-Kann Defense
1406,1391,55,resign,black,15,B12,Caro-Kann Defense
1631,1500,44,resign,black,131,B10,Caro-Kann Defense
1965,1940,102,time,black,25,B10,Caro-Kann Defense
1333,1289,58,resign,black,44,B10,Caro-Kann Defense
1529,1247,76,resign,black,282,B10,Caro-Kann Defense
1861,1899,24,mate,black,38,B10,Caro-Kann Defense: Accelerated Panov Attack #2
1277,1306,86,resign,black,29,B12,Caro-Kann Defense: Advance Variation
1644,1728,77,resign,black,84,B12,Caro-Kann Defense: Advance Variation
2164,2157,66,resign,black,7,B12,Caro-Kann Defense: Advance Variation
1448,1705,62,mate,black,257,B12,Caro-Kann Defense: Advance Variation
1549,1676,40,mate,black,127,B12,Caro-Kann Defense: Advance Variation
1627,1321,61,resign,black,306,B12,Caro-Kann Defense: Advance Variation
1538,1662,46,resign,black,124,B12,Caro-Kann Defense: Advance Variation
1834,1994,50,resign,black,160,B12,Caro-Kann Defense: Advance Variation |  Botvinnik-Carls Defense
1534,1868,52,resign,black,334,B12,Caro-Kann Defense: Advance Variation |  Botvinnik-Carls Defense
1802,1740,156,time,black,62,B12,Caro-Kann Defense: Advance Variation |  Botvinnik-Carls Defense
2239,2151,66,time,black,88,B12,Caro-Kann Defense: Advance Variation |  Botvinnik-Carls Defense
1455,2264,46,resign,black,809,B12,Caro-Kann Defense: Advance Variation |  Bronstein Variation
1587,1811,64,time,black,224,B12,Caro-Kann Defense: Advance Variation |  Short Variation
1528,1468,70,mate,black,60,B12,Caro-Kann Defense: Advance Variation |  Short Variation
1715,1651,30,mate,black,64,B12,Caro-Kann Defense: Advance Variation |  Short Variation
1280,1685,38,resign,black,405,B12,Caro-Kann Defense: Advance Variation |  Short Variation
1711,1753,140,mate,black,42,B12,Caro-Kann Defense: Advance Variation |  Van der Wiel Attack
1523,1571,36,resign,black,48,B10,Caro-Kann Defense: Breyer Variation
1450,1558,78,time,black,108,B10,Caro-Kann Defense: Breyer Variation
1178,1346,62,resign,black,168,B18,Caro-Kann Defense: Classical Variation
1370,1500,58,mate,black,130,B18,Caro-Kann Defense: Classical Variation
1702,1664,132,resign,black,38,B18,Caro-Kann Defense: Classical Variation
1396,1672,34,mate,black,276,B18,Caro-Kann Defense: Classical Variation
1967,2116,92,resign,black,149,B18,Caro-Kann Defense: Classical Variation |  Main Line
2262,2111,64,resign,black,151,B19,Caro-Kann Defense: Classical |  Spassky Variation
1468,1633,120,mate,black,165,B10,Caro-Kann Defense: Euwe Attack
1273,1409,24,resign,black,136,B13,Caro-Kann Defense: Exchange Variation
2105,1929,160,resign,black,176,B13,Caro-Kann Defense: Exchange Variation
1553,1942,62,time,black,389,B13,Caro-Kann Defense: Exchange Variation
1032,1274,132,mate,black,242,B13,Caro-Kann Defense: Exchange Variation
2160,2214,150,resign,black,54,B13,Caro-Kann Defense: Exchange Variation
2213,2323,158,mate,black,110,B13,Caro-Kann Defense: Exchange Variation
1716,1886,70,resign,black,170,B13,Caro-Kann Defense: Exchange Variation
1015,1563,74,resign,black,548,B13,Caro-Kann Defense: Exchange Variation
1141,1168,42,resign,black,27,B00,Caro-Kann Defense: Hillbilly Attack
1500,1279,30,mate,black,221,B00,Caro-Kann Defense: Hillbilly Attack
964,1267,70,resign,black,303,B00,Caro-Kann Defense: Hillbilly Attack
1887,2045,70,resign,black,158,B00,Caro-Kann Defense: Hillbilly Attack
1337,1532,58,mate,black,195,B00,Caro-Kann Defense: Hillbilly Attack
1356,1708,34,resign,black,352,B12,Caro-Kann Defense: Maroczy Variation
1104,1057,50,mate,black,47,B12,Caro-Kann Defense: Maroczy Variation
1776,1383,82,mate,black,393,B10,Caro-Kann Defense: Masi Variation
1996,1886,144,resign,black,110,B14,Caro-Kann Defense: Panov Attack
2120,2170,90,resign,black,50,B13,Caro-Kann Defense: Panov Attack |  Gunderam Attack
1673,1992,43,resign,black,319,B15,Caro-Kann Defense: Rasa-Studier Gambit
1393,1314,122,time,black,79,B10,Caro-Kann Defense: Two Knights Attack
1419,1382,38,resign,black,37,B10,Caro-Kann Defense: Two Knights Attack
1407,1390,60,mate,black,17,B12,Caro-Kann Defense: Ulysses Gambit
1799,1811,42,mate,black,12,B12,Caro-Kann Defense: Ulysses Gambit
1347,1800,46,mate,black,453,C21,Center Game
1408,1628,68,mate,black,220,C21,Center Game
1446,1133,78,mate,black,313,C21,Center Game
1438,1467,32,mate,black,29,C21,Center Game
1354,1423,84,resign,black,69,C21,Center Game #2
1373,1639,72,resign,black,266,C21,Center Game #2
1074,1292,42,resign,black,218,C21,Center Game #2
1182,1429,38,resign,black,247,C21,Center Game #2
1112,1151,62,resign,black,39,C21,Center Game #2
1246,1565,60,resign,black,319,C21,Center Game #2
1558,1610,28,resign,black,52,C21,Center Game #2
1749,1404,18,resign,black,345,C21,Center Game #2
1500,1387,26,mate,black,113,C21,Center Game #2
960,1005,32,mate,black,45,C21,Center Game #2
964,1249,64,mate,black,285,C21,Center Game #2
1564,1437,86,mate,black,127,C21,Center Game #2
1143,1237,34,resign,black,94,C21,Center Game #2
1841,1921,96,resign,black,80,C22,Center Game: Berger Variation
1702,1649,128,mate,black,53,C22,Center Game: Berger Variation
1593,1737,38,resign,black,144,C22,Center Game: Berger Variation
1604,1757,70,resign,black,153,C22,Center Game: Berger Variation
1328,1498,12,resign,black,170,C22,Center Game: Hall Variation
1540,1341,60,mate,black,199,C22,Center Game: Hall Variation
1274,1569,28,resign,black,295,C22,Center Game: Hall Variation
1411,1953,34,mate,black,542,C22,Center Game: Hall Variation
1577,1483,50,resign,black,94,C21,Center Game: Kieseritzky Variation #3
886,1659,48,mate,black,773,C21,Center Game: Kieseritzky Variation #4
1535,1579,66,mate,black,44,C21,Center Game: Lanc-Arnold Gambit |  Schippler Gambit
1375,1334,24,resign,black,41,C22,Center Game: Normal Variation
1383,1606,46,mate,black,223,C22,Center Game: Normal Variation
1368,1381,68,resign,black,13,C22,Center Game: Normal Variation
1349,1832,66,mate,black,483,C22,Center Game: Normal Variation
1345,1400,30,mate,black,55,C22,Center Game: Normal Variation
1403,1613,68,mate,black,210,C22,Center Game: Normal Variation
1419,1449,56,mate,black,30,C22,Center Game: Normal Variation
1208,1140,22,time,black,68,C22,Center Game: Normal Variation
1587,1519,44,resign,black,68,C22,Center Game: Normal Variation
1416,1625,50,mate,black,209,C22,Center Game: Normal Variation
1287,1798,36,mate,black,511,C22,Center Game: Normal Variation
1770,1952,70,mate,black,182,C22,Center Game: Normal Variation
1067,1263,60,mate,black,196,C22,Center Game: Normal Variation
1997,1480,70,mate,black,517,C22,Center Game: Paulsen Attack Variation
1552,1625,64,mate,black,73,C22,Center Game: Paulsen Attack Variation
1688,1485,96,resign,black,203,C22,Center Game: Paulsen Attack Variation
1749,1404,72,resign,black,345,C22,Center Game: Paulsen Attack Variation
1484,1738,30,resign,black,254,C21,Center Game: Ross Gambit
1841,2264,50,resign,black,423,A00,Clemenz Opening
1418,1588,6,mate,black,170,A00,Clemenz Opening
1228,1812,14,resign,black,584,A00,Clemenz Opening
1479,1806,56,mate,black,327,D05,Colle System
1807,1687,18,resign,black,120,D05,Colle System
1786,1609,40,resign,black,177,D05,Colle System
1355,1418,50,resign,black,63,D05,Colle System
1006,1228,162,mate,black,222,D05,Colle System
1560,1475,78,resign,black,85,D05,Colle System
1384,1395,21,resign,black,11,D05,Colle System #2
1381,1646,43,resign,black,265,D05,Colle System #2
1251,1545,58,mate,black,294,A00,Crab Opening
1041,1600,9,resign,black,559,A00,Crab Opening
1369,1364,34,mate,black,5,A00,Creepy Crawly Formation: Classical Defense
1557,1569,78,mate,black,12,A00,Creepy Crawly Formation: Classical Defense
1440,1693,176,mate,black,253,C21,Danish Gambit
1727,1590,36,resign,black,137,C21,Danish Gambit
1560,1596,129,resign,black,36,C21,Danish Gambit
1570,1569,51,resign,black,1,C21,Danish Gambit Accepted |  Classical Defense
1799,2193,36,resign,black,394,C21,Danish Gambit Accepted |  Copenhagen Defense
1271,1703,40,resign,black,432,C21,Danish Gambit Accepted |  Copenhagen Defense
2201,2173,130,mate,black,28,A46,Doery Defense
1493,1315,88,mate,black,178,A80,Dutch Defense
1509,1868,70,resign,black,359,A84,Dutch Defense
1839,1632,24,resign,black,207,A80,Dutch Defense
2163,2012,26,resign,black,151,A80,Dutch Defense
1243,1357,56,mate,black,114,A80,Dutch Defense
1879,1841,108,resign,black,38,A85,Dutch Defense: Queen's Knight Variation
1357,2193,94,mate,black,836,A85,Dutch Defense: Queen's Knight Variation
1997,1500,54,resign,black,497,A82,Dutch Defense: Staunton Gambit Accepted
1660,1549,119,resign,black,111,A49,East Indian Defense
2066,1937,104,resign,black,129,A49,East Indian Defense
1216,1344,54,mate,black,128,A49,East Indian Defense
1666,1647,41,resign,black,19,C40,Elephant Gambit
1822,1588,60,mate,black,234,C40,Elephant Gambit
1440,1474,66,mate,black,34,C40,Elephant Gambit
1400,1439,20,resign,black,39,C40,Elephant Gambit
1281,1684,30,mate,black,403,C40,Elephant Gambit: Maroczy Gambit
1810,1495,20,resign,black,315,C40,Elephant Gambit: Paulsen Countergambit
1884,1830,82,resign,black,54,C40,Elephant Gambit: Paulsen Countergambit
1257,1658,45,resign,black,401,C40,Elephant Gambit: Paulsen Countergambit
1728,2027,50,resign,black,299,A40,English Defense
1922,1839,26,resign,black,83,A40,English Defense #2
1873,1905,37,resign,black,32,A40,English Defense #2
1850,1923,96,resign,black,73,A40,English Defense #2
1375,1361,58,resign,black,14,A40,English Defense #2
1608,1875,60,time,black,267,A40,English Defense #2
1671,1668,52,mate,black,3,A40,English Defense #2
1486,994,68,mate,black,492,A40,English Defense #2
1602,1629,52,mate,black,27,A10,English Opening
1375,1435,6,resign,black,60,A10,English Opening
1687,1709,114,resign,black,22,A10,English Opening
1221,1238,30,mate,black,17,A10,English Opening: Achilles-Omega Gambit
966,1185,62,mate,black,219,A10,English Opening: Achilles-Omega Gambit
1502,1469,40,resign,black,33,A13,English Opening: Agincourt Defense
1479,1514,26,resign,black,35,A13,English Opening: Agincourt Defense
1459,1566,30,resign,black,107,A13,English Opening: Agincourt Defense
1278,1308,54,resign,black,30,A10,English Opening: Anglo-Dutch Defense
1513,1541,54,resign,black,28,A10,English Opening: Anglo-Dutch Defense
2279,1826,52,resign,black,453,A10,English Opening: Anglo-Dutch Defense
1830,2126,56,resign,black,296,A16,English Opening: Anglo-Gruenfeld Defense
1369,1542,56,resign,black,173,A16,English Opening: Anglo-Gruenfeld Defense
1703,1943,98,resign,black,240,A15,English Opening: Anglo-Indian Defense
1749,2040,32,resign,black,291,A15,English Opening: Anglo-Indian Defense
1652,1702,64,resign,black,50,A15,English Opening: Anglo-Indian Defense
1509,1930,56,mate,black,421,A15,English Opening: Anglo-Indian Defense
2355,2449,120,resign,black,94,A16,English Opening: Anglo-Indian Defense |  Anglo-Gruenfeld Variation #3
1853,1809,62,resign,black,44,A17,English Opening: Anglo-Indian Defense |  Hedgehog System
1513,1527,52,resign,black,14,A17,English Opening: Anglo-Indian Defense |  Hedgehog System
949,1064,80,resign,black,115,A15,English Opening: Anglo-Indian Defense |  King's Indian Formation
2013,2274,102,resign,black,261,A16,English Opening: Anglo-Indian Defense |  Queen's Knight Variation
1561,1616,66,resign,black,55,A16,English Opening: Anglo-Indian Defense |  Queen's Knight Variation
1547,1626,54,resign,black,79,A15,English Opening: Anglo-Indian Defense |  Scandinavian Defense
1367,1505,37,resign,black,138,A15,English Opening: Anglo-Indian Defense |  Scandinavian Defense
2017,2167,60,time,black,150,A15,English Opening: Anglo-Indian Defense |  Scandinavian Defense |  Exchange Variation
1431,1426,48,resign,black,5,A10,English Opening: Anglo-Lithuanian Variation
1455,1448,21,resign,black,7,A10,English Opening: Anglo-Scandinavian Defense
1771,1857,68,resign,black,86,A10,English Opening: Anglo-Scandinavian Defense
1221,1368,90,mate,black,147,A10,English Opening: Anglo-Scandinavian Defense
1568,1622,126,resign,black,54,A10,English Opening: Anglo-Scandinavian Defense
1552,1530,56,resign,black,22,A10,English Opening: Anglo-Scandinavian Defense
2031,2086,78,time,black,55,A10,English Opening: Anglo-Scandinavian Defense
1392,1608,37,resign,black,216,A22,English Opening: Carls-Bremen System
1492,1563,14,resign,black,71,A22,English Opening: Carls-Bremen System
1994,1917,60,resign,black,77,A22,English Opening: Carls-Bremen System
1746,1712,120,mate,black,34,A11,English Opening: Caro-Kann Defensive System
1549,1456,112,resign,black,93,A11,English Opening: Caro-Kann Defensive System
1425,1415,58,mate,black,10,A11,English Opening: Caro-Kann Defensive System
1830,1861,72,resign,black,31,A11,English Opening: Caro-Kann Defensive System
1769,1659,74,mate,black,110,A10,English Opening: Great Snake Variation
1978,2457,24,resign,black,479,A10,English Opening: Great Snake Variation
1260,1438,82,time,black,178,A10,English Opening: Great Snake Variation
1734,1747,56,resign,black,13,A10,English Opening: Great Snake Variation
1996,2132,68,mate,black,136,A10,English Opening: Jaenisch Gambit
1704,1824,42,mate,black,120,A20,English Opening: King's English Variation
1577,1534,30,mate,black,43,A20,English Opening: King's English Variation
1592,1783,86,mate,black,191,A20,English Opening: King's English Variation
1585,1632,40,mate,black,47,A20,English Opening: King's English Variation
1092,1144,72,mate,black,52,A20,English Opening: King's English Variation
1499,1501,40,mate,black,2,A20,English Opening: King's English Variation
1497,1820,44,mate,black,323,A20,English Opening: King's English Variation
1479,1462,104,mate,black,17,A20,English Opening: King's English Variation
1545,1402,18,resign,black,143,A20,English Opening: King's English Variation
2193,2181,48,resign,black,12,A20,English Opening: King's English Variation
1703,1735,54,resign,black,32,A20,English Opening: King's English Variation
1726,1789,56,resign,black,63,A20,English Opening: King's English Variation
1735,1753,76,resign,black,18,A20,English Opening: King's English Variation
1744,1748,60,time,black,4,A20,English Opening: King's English Variation
1756,1737,42,mate,black,19,A20,English Opening: King's English Variation
1769,1838,86,time,black,69,A20,English Opening: King's English Variation
1052,1318,64,mate,black,266,A20,English Opening: King's English Variation
1560,1713,44,mate,black,153,A28,English Opening: King's English Variation |  Four Knights Variation #2
1953,1973,38,resign,black,20,A29,English Opening: King's English Variation |  Four Knights Variation |  Fianchetto Line
2058,1798,96,resign,black,260,A28,English Opening: King's English Variation |  Four Knights Variation |  Quiet Line #3
1297,1330,108,mate,black,33,A21,English Opening: King's English Variation |  Kramnik-Shirov Counterattack
1620,1817,30,resign,black,197,A21,English Opening: King's English Variation |  Kramnik-Shirov Counterattack
1492,1646,78,mate,black,154,A20,English Opening: King's English Variation |  Nimzowitsch Variation
1205,1279,46,resign,black,74,A20,English Opening: King's English Variation |  Nimzowitsch-Flohr Variation
1546,1517,54,resign,black,29,A25,English Opening: King's English Variation |  Reversed Closed Sicilian
2036,1882,40,mate,black,154,A25,English Opening: King's English Variation |  Reversed Closed Sicilian
1614,1608,37,resign,black,6,A25,English Opening: King's English Variation |  Reversed Closed Sicilian
1365,1163,22,resign,black,202,A21,English Opening: King's English Variation |  Reversed Sicilian
1481,1436,39,resign,black,45,A21,English Opening: King's English Variation |  Reversed Sicilian
1138,1276,128,mate,black,138,A21,English Opening: King's English Variation |  Reversed Sicilian
1466,1458,90,mate,black,8,A21,English Opening: King's English Variation |  Reversed Sicilian
1475,1314,53,resign,black,161,A21,English Opening: King's English Variation |  Reversed Sicilian
1593,1348,8,mate,black,245,A21,English Opening: King's English Variation |  Reversed Sicilian
1653,1716,125,resign,black,63,A21,English Opening: King's English Variation |  Reversed Sicilian
1396,1638,92,resign,black,242,A21,English Opening: King's English Variation |  Reversed Sicilian
1186,1283,32,resign,black,97,A27,English Opening: King's English Variation |  Three Knights System
1256,1301,48,resign,black,45,A27,English Opening: King's English Variation |  Three Knights System
1929,2106,126,time,black,177,A27,English Opening: King's English Variation |  Three Knights System
1698,1154,22,resign,black,544,A22,English Opening: King's English Variation |  Two Knights Variation
1454,1613,54,resign,black,159,A22,English Opening: King's English Variation |  Two Knights Variation
2004,1967,36,resign,black,37,A22,English Opening: King's English Variation |  Two Knights Variation
2001,2105,46,resign,black,104,A22,English Opening: King's English Variation |  Two Knights Variation |  Reversed Dragon
1479,1427,63,resign,black,52,A22,English Opening: King's English Variation |  Two Knights Variation |  Reversed Dragon
1612,1531,118,time,black,81,A22,English Opening: King's English Variation |  Two Knights Variation |  Smyslov System
1733,1672,78,mate,black,61,A30,English Opening: Symmetrical Variation
1433,1653,57,resign,black,220,A30,English Opening: Symmetrical Variation
1494,1506,50,resign,black,12,A30,English Opening: Symmetrical Variation
1836,1814,60,resign,black,22,A30,English Opening: Symmetrical Variation
1275,1253,80,resign,black,22,A30,English Opening: Symmetrical Variation
1649,1500,64,time,black,149,A30,English Opening: Symmetrical Variation
1584,1611,62,resign,black,27,A31,English Opening: Symmetrical Variation |  Anti-Benoni Variation
1927,2193,40,resign,black,266,A33,English Opening: Symmetrical Variation |  Anti-Benoni Variation |  Spielmann Defense
1483,1521,14,resign,black,38,A36,English Opening: Symmetrical Variation |  Fianchetto Variation
2044,1867,148,mate,black,177,A34,English Opening: Symmetrical Variation |  Fianchetto Variation
1673,1729,90,time,black,56,A38,English Opening: Symmetrical Variation |  Full Symmetry Line
1852,1862,74,resign,black,10,A39,English Opening: Symmetrical Variation |  Mecking Variation
1707,1696,47,resign,black,11,A34,English Opening: Symmetrical Variation |  Normal Variation
1389,2297,37,resign,black,908,A35,English Opening: Symmetrical Variation |  Two Knights Variation
1221,1820,26,mate,black,599,C20,English Opening: The Whale
1500,1503,98,resign,black,3,C20,English Opening: The Whale
1448,1280,8,mate,black,168,C20,English Opening: The Whale
999,1068,78,mate,black,69,C20,English Opening: The Whale
1734,1701,90,resign,black,33,C20,English Opening: The Whale
1344,1648,58,mate,black,304,C20,English Opening: The Whale
1453,1432,18,resign,black,21,C20,English Opening: The Whale
1317,1246,96,mate,black,71,C20,English Opening: The Whale
1480,1491,66,mate,black,11,C20,English Opening: The Whale
1500,1670,56,mate,black,170,C20,English Opening: The Whale
1507,1399,59,resign,black,108,A40,Englund Gambit
1785,1840,69,resign,black,55,A40,Englund Gambit
1771,1831,74,resign,black,60,A40,Englund Gambit
983,1090,110,mate,black,107,A40,Englund Gambit
1246,1753,26,mate,black,507,A40,Englund Gambit
1246,1753,26,mate,black,507,A40,Englund Gambit
1610,989,2,resign,black,621,A40,Englund Gambit
2347,2394,98,resign,black,47,A40,Englund Gambit
1500,1860,58,mate,black,360,A40,Englund Gambit
1471,1702,30,resign,black,231,A40,Englund Gambit
1699,1704,94,time,black,5,A40,Englund Gambit
1301,1664,50,mate,black,363,A40,Englund Gambit Complex: Hartlaub-Charlick Gambit
1291,1037,98,time,black,254,A40,Englund Gambit Declined |  Reversed Alekhine
1311,1272,60,resign,black,39,A40,Englund Gambit Declined |  Reversed French
1500,1782,98,resign,black,282,A40,Englund Gambit Declined |  Reversed French
1449,1636,30,resign,black,187,A40,Englund Gambit Declined |  Reversed French
1529,1736,30,resign,black,207,A40,Englund Gambit Declined |  Reversed French
2254,2117,36,time,black,137,A40,Englund Gambit Declined |  Reversed French
1323,1350,56,mate,black,27,A40,Englund Gambit Declined |  Reversed French
1389,1555,46,resign,black,166,A40,Englund Gambit Declined |  Reversed French
1254,1322,39,resign,black,68,A40,Englund Gambit Declined |  Reversed Krebs
1223,1297,42,resign,black,74,A40,Englund Gambit Declined |  Reversed Krebs
1217,1611,6,time,black,394,C46,Four Knights Game
1426,1481,128,resign,black,55,C46,Four Knights Game
1722,1612,96,mate,black,110,C46,Four Knights Game
1500,1398,62,time,black,102,C46,Four Knights Game
1576,2023,84,mate,black,447,C46,Four Knights Game
1558,1479,36,resign,black,79,C46,Four Knights Game
1188,1716,22,mate,black,528,C46,Four Knights Game
948,1271,14,resign,black,323,C46,Four Knights Game
1199,1355,54,resign,black,156,C46,Four Knights Game
1321,1946,54,mate,black,625,C46,Four Knights Game
1331,1746,104,mate,black,415,C49,Four Knights Game: Double Spanish
1354,1252,55,resign,black,102,C49,Four Knights Game: Double Spanish
1534,1415,46,resign,black,119,C46,Four Knights Game: Gunsberg Variation
1500,1675,114,resign,black,175,C46,Four Knights Game: Gunsberg Variation
2306,2405,86,resign,black,99,C46,Four Knights Game: Halloween Gambit
1256,1298,114,mate,black,42,C46,Four Knights Game: Halloween Gambit
1306,1298,32,resign,black,8,C50,Four Knights Game: Italian Variation
1376,1418,58,resign,black,42,C50,Four Knights Game: Italian Variation
1523,1375,29,resign,black,148,C46,Four Knights Game: Italian Variation
1298,1800,30,resign,black,502,C50,Four Knights Game: Italian Variation
1285,1623,48,resign,black,338,C46,Four Knights Game: Italian Variation
1271,1549,136,mate,black,278,C46,Four Knights Game: Italian Variation
1171,1648,33,resign,black,477,C50,Four Knights Game: Italian Variation
1700,1684,57,resign,black,16,C46,Four Knights Game: Italian Variation
1564,1761,41,resign,black,197,C50,Four Knights Game: Italian Variation
1356,1752,54,mate,black,396,C46,Four Knights Game: Italian Variation
1449,1551,48,mate,black,102,C46,Four Knights Game: Italian Variation
1434,1265,34,mate,black,169,C50,Four Knights Game: Italian Variation
1104,1449,42,mate,black,345,C46,Four Knights Game: Italian Variation
1303,1613,74,resign,black,310,C46,Four Knights Game: Italian Variation
1563,2258,56,resign,black,695,C46,Four Knights Game: Italian Variation
2139,1557,82,time,black,582,C50,Four Knights Game: Italian Variation
1739,1713,66,time,black,26,C46,Four Knights Game: Italian Variation
1733,1875,30,resign,black,142,C50,Four Knights Game: Italian Variation
1793,1640,40,resign,black,153,C46,Four Knights Game: Italian Variation
1622,2322,48,resign,black,700,C47,Four Knights Game: Italian Variation |  Noa Gambit
1555,1632,96,mate,black,77,C48,Four Knights Game: Ranken Variation
1315,1163,138,resign,black,152,C47,Four Knights Game: Scotch Variation
1312,1152,48,resign,black,160,C47,Four Knights Game: Scotch Variation
1268,1202,38,resign,black,66,C47,Four Knights Game: Scotch Variation
944,1151,21,resign,black,207,C47,Four Knights Game: Scotch Variation
2220,2464,42,resign,black,244,C47,Four Knights Game: Scotch Variation Accepted
1284,1261,26,resign,black,23,C47,Four Knights Game: Scotch Variation Accepted
2126,2221,40,resign,black,95,C47,Four Knights Game: Scotch Variation Accepted
1155,1459,134,mate,black,304,C47,Four Knights Game: Scotch Variation Accepted
1731,1854,106,resign,black,123,C47,Four Knights Game: Scotch Variation Accepted
1261,1186,66,resign,black,75,C47,Four Knights Game: Scotch Variation Accepted
1906,1672,102,resign,black,234,C47,Four Knights Game: Scotch Variation Accepted
1360,1330,66,resign,black,30,C48,Four Knights Game: Spanish Variation
1606,1465,26,resign,black,141,C48,Four Knights Game: Spanish Variation
1975,1908,64,resign,black,67,C48,Four Knights Game: Spanish Variation |  Classical Variation
1638,2075,70,resign,black,437,C48,Four Knights Game: Spanish Variation |  Classical Variation
1254,1204,44,mate,black,50,C48,Four Knights Game: Spanish Variation |  Classical Variation
1488,1591,20,mate,black,103,C48,Four Knights Game: Spanish Variation |  Classical Variation
2293,2282,140,resign,black,11,C48,Four Knights Game: Spanish Variation |  Classical Variation
1393,1415,68,resign,black,22,C48,Four Knights Game: Spanish Variation |  Classical Variation
1931,2061,72,resign,black,130,C48,Four Knights Game: Spanish Variation |  Rubinstein Variation
2306,2438,86,resign,black,132,C48,Four Knights Game: Spanish Variation |  Rubinstein Variation
1386,1326,48,mate,black,60,C48,Four Knights Game: Spanish Variation |  Rubinstein Variation Accepted
1544,1523,55,resign,black,21,A43,Franco-Benoni Defense
981,1181,21,resign,black,200,C00,French Defense
1278,1406,104,mate,black,128,C00,French Defense
1173,1718,64,mate,black,545,C00,French Defense
1705,1781,28,resign,black,76,C00,French Defense
1618,1568,40,mate,black,50,C00,French Defense #2
1493,1678,71,resign,black,185,C00,French Defense #2
1805,2195,33,resign,black,390,C00,French Defense #2
1516,1593,96,mate,black,77,C00,French Defense #2
1343,1406,86,resign,black,63,C00,French Defense #2
1155,1265,94,resign,black,110,C00,French Defense #2
1626,1820,28,resign,black,194,C00,French Defense #2
1928,2051,54,resign,black,123,C00,French Defense #2
1805,1680,42,resign,black,125,C00,French Defense #2
1309,1770,26,mate,black,461,C00,French Defense #2
1415,1472,71,resign,black,57,C00,French Defense #2
1554,1689,116,mate,black,135,C00,French Defense #2
1151,1666,52,mate,black,515,C00,French Defense #2
1689,1648,60,resign,black,41,C00,French Defense #2
1194,1201,24,resign,black,7,C00,French Defense #2
1679,1640,20,time,black,39,C00,French Defense #2
970,1065,67,resign,black,95,C00,French Defense #2
930,1099,58,resign,black,169,C00,French Defense #2
1500,1415,22,mate,black,85,C00,French Defense #2
1430,1366,2,resign,black,64,C00,French Defense #2
1642,1585,112,resign,black,57,C00,French Defense #2
1590,1829,48,mate,black,239,C02,French Defense: Advance Variation
1526,1830,104,mate,black,304,C02,French Defense: Advance Variation
1891,1805,60,mate,black,86,C02,French Defense: Advance Variation
1947,2114,36,resign,black,167,C02,French Defense: Advance Variation
1681,1862,32,resign,black,181,C02,French Defense: Advance Variation
1658,1678,64,mate,black,20,C02,French Defense: Advance Variation
1760,1718,76,mate,black,42,C02,French Defense: Advance Variation #2
1628,1538,78,resign,black,90,C02,French Defense: Advance Variation #2
1315,1455,54,resign,black,140,C02,French Defense: Advance Variation #2
1299,1500,88,mate,black,201,C02,French Defense: Advance Variation #2
1681,1796,71,resign,black,115,C02,French Defense: Advance Variation #2
1474,1609,46,resign,black,135,C02,French Defense: Advance Variation #2
1834,1835,82,resign,black,1,C02,French Defense: Advance Variation #2
1648,1707,57,resign,black,59,C02,French Defense: Advance Variation #2
1330,1345,48,resign,black,15,C02,French Defense: Advance Variation #3
1515,1404,54,time,black,111,C02,French Defense: Advance Variation #3
1240,1219,56,mate,black,21,C02,French Defense: Advance Variation #3
1274,1503,48,mate,black,229,C02,French Defense: Advance Variation #3
1302,1338,62,time,black,36,C02,French Defense: Advance Variation #3
1465,1618,48,resign,black,153,C02,French Defense: Advance Variation #3
1605,1521,56,resign,black,84,C02,French Defense: Advance Variation #3
1006,1399,92,resign,black,393,C02,French Defense: Advance Variation #3
1649,1547,38,resign,black,102,C02,French Defense: Advance Variation #4
1327,1542,38,mate,black,215,C02,French Defense: Advance Variation #4
1347,1604,18,resign,black,257,C02,French Defense: Advance Variation #4
1154,1679,114,resign,black,525,C02,French Defense: Advance Variation #4
1453,1466,50,mate,black,13,C02,French Defense: Advance Variation |  Euwe Variation
2054,2123,150,time,black,69,C02,French Defense: Advance Variation |  Euwe Variation
1738,1801,24,resign,black,63,C02,French Defense: Advance Variation |  Euwe Variation
1622,1842,60,resign,black,220,C02,French Defense: Advance Variation |  Euwe Variation
1697,1770,66,resign,black,73,C02,French Defense: Advance Variation |  Euwe Variation
1717,1640,32,mate,black,77,C02,French Defense: Advance Variation |  Milner-Barry Gambit
1962,2091,104,resign,black,129,C02,French Defense: Advance Variation |  Nimzowitsch Gambit
1240,1297,48,time,black,57,C02,French Defense: Advance Variation |  Nimzowitsch System
1526,1253,60,mate,black,273,C02,French Defense: Advance Variation |  Nimzowitsch System
1248,1239,150,mate,black,9,C02,French Defense: Advance Variation |  Nimzowitsch System
1878,1801,61,resign,black,77,C02,French Defense: Advance Variation |  Nimzowitsch System
1489,1540,56,mate,black,51,C02,French Defense: Advance Variation |  Nimzowitsch System
1334,1768,60,mate,black,434,C02,French Defense: Advance Variation |  Nimzowitsch System
1744,1735,46,resign,black,9,C02,French Defense: Advance Variation |  Paulsen Attack
1469,1357,116,time,black,112,C02,French Defense: Advance Variation |  Paulsen Attack
1905,1851,34,resign,black,54,C02,French Defense: Advance Variation |  Paulsen Attack
1885,1897,66,resign,black,12,C02,French Defense: Advance Variation |  Paulsen Attack
1949,2104,112,resign,black,155,C02,French Defense: Advance Variation |  Paulsen Attack
1894,2133,46,resign,black,239,C02,French Defense: Advance Variation |  Paulsen Attack
1545,1622,52,mate,black,77,C02,French Defense: Advance Variation |  Paulsen Attack
1915,2198,54,resign,black,283,C02,French Defense: Advance Variation |  Paulsen Attack
1207,1588,54,mate,black,381,C02,French Defense: Advance |  Steinitz Variation
1948,2159,65,resign,black,211,C13,French Defense: Alekhine-Chatard Attack |  Breyer Variation
1307,1187,60,time,black,120,C01,French Defense: Baeuerle Gambit
1335,1241,44,mate,black,94,C00,French Defense: Bird Invitation
1503,2041,53,resign,black,538,C01,French Defense: Carlson Gambit
1277,1409,40,mate,black,132,C11,French Defense: Classical Variation
1053,1060,40,mate,black,7,C11,French Defense: Classical Variation
1741,1871,120,mate,black,130,C11,French Defense: Classical Variation |  Delayed Exchange Variation
1311,1623,80,time,black,312,C11,French Defense: Classical Variation |  Delayed Exchange Variation
2118,1817,84,resign,black,301,C13,French Defense: Classical Variation |  Normal Variation
1568,1581,78,mate,black,13,C14,French Defense: Classical Variation |  Steinitz Variation
1667,1807,82,time,black,140,C14,French Defense: Classical Variation |  Steinitz Variation
1253,1205,66,mate,black,48,C11,French Defense: Classical Variation |  Steinitz Variation
1555,1618,76,resign,black,63,C11,French Defense: Classical Variation |  Steinitz Variation
1584,1669,70,resign,black,85,C11,French Defense: Classical Variation |  Steinitz Variation
1915,2009,50,resign,black,94,C11,French Defense: Classical Variation |  Steinitz Variation
1978,1916,66,resign,black,62,C11,French Defense: Classical Variation |  Steinitz Variation
943,1013,40,resign,black,70,C10,French Defense: Classical Variation |  Svenonius Variation
1572,1688,34,mate,black,116,C01,French Defense: Exchange Variation
1690,1913,52,mate,black,223,C01,French Defense: Exchange Variation
1851,1887,70,resign,black,36,C01,French Defense: Exchange Variation
1874,1774,52,resign,black,100,C01,French Defense: Exchange Variation
1846,1977,76,resign,black,131,C01,French Defense: Exchange Variation
1857,1852,94,mate,black,5,C01,French Defense: Exchange Variation
1889,1999,76,resign,black,110,C01,French Defense: Exchange Variation
2021,1857,66,resign,black,164,C01,French Defense: Exchange Variation
1906,2006,62,mate,black,100,C01,French Defense: Exchange Variation
2057,1949,154,resign,black,108,C01,French Defense: Exchange Variation
1575,2240,16,mate,black,665,C01,French Defense: Exchange Variation
1355,1450,20,resign,black,95,C01,French Defense: Exchange Variation
1363,1623,52,resign,black,260,C01,French Defense: Exchange Variation
1915,2258,74,resign,black,343,C01,French Defense: Exchange Variation
1965,2087,154,time,black,122,C01,French Defense: Exchange Variation |  Monte Carlo Variation
1769,1791,44,mate,black,22,C01,French Defense: Exchange Variation |  Svenonius Variation
1561,1496,52,resign,black,65,C01,French Defense: Exchange Variation |  Svenonius Variation
1567,1550,86,resign,black,17,C01,French Defense: Exchange Variation |  Svenonius Variation
1589,1445,44,resign,black,144,C01,French Defense: Franco-Hiva Gambit I Accepted
1619,1574,96,time,black,45,C00,French Defense: Franco-Hiva Gambit II
1777,1736,32,mate,black,41,C00,French Defense: Horwitz Attack
1547,971,72,resign,black,576,C00,French Defense: King's Indian Attack
1585,1861,18,resign,black,276,C00,French Defense: King's Indian Attack
1530,1561,84,resign,black,31,C00,French Defense: King's Indian Attack
1009,1179,70,mate,black,170,C00,French Defense: King's Indian Attack
1047,1202,82,mate,black,155,C00,French Defense: King's Indian Attack
1023,1246,14,resign,black,223,C00,French Defense: King's Indian Attack
1289,1732,62,mate,black,443,C00,French Defense: King's Indian Attack
1727,1825,36,resign,black,98,C00,French Defense: King's Indian Attack
1207,1579,37,resign,black,372,C00,French Defense: Knight Variation
1409,1548,34,mate,black,139,C00,French Defense: Knight Variation
1597,1728,70,mate,black,131,C00,French Defense: Knight Variation
1860,1820,44,resign,black,40,C00,French Defense: Knight Variation
1426,1527,110,resign,black,101,C00,French Defense: Knight Variation
1320,1400,76,resign,black,80,C00,French Defense: Knight Variation
1676,1680,30,resign,black,4,C00,French Defense: Knight Variation
1378,1318,36,resign,black,60,C00,French Defense: Knight Variation
1475,1585,114,resign,black,110,C00,French Defense: Knight Variation
1748,1852,50,resign,black,104,C00,French Defense: Knight Variation
1365,1850,19,resign,black,485,C00,French Defense: Knight Variation
1802,1691,40,resign,black,111,C00,French Defense: Knight Variation
1804,1837,48,resign,black,33,C00,French Defense: Knight Variation
1778,1757,60,resign,black,21,C00,French Defense: Knight Variation
1285,1383,40,mate,black,98,C00,French Defense: Knight Variation
1390,1201,114,mate,black,189,C00,French Defense: Knight Variation
1383,1045,42,mate,black,338,C00,French Defense: Knight Variation
1383,1045,26,resign,black,338,C00,French Defense: Knight Variation
1383,1045,52,mate,black,338,C00,French Defense: Knight Variation
1348,1460,110,resign,black,112,C00,French Defense: Knight Variation
1825,1869,54,resign,black,44,C00,French Defense: Knight Variation
1730,1893,55,resign,black,163,C00,French Defense: Knight Variation
1429,1552,80,mate,black,123,C00,French Defense: Knight Variation
1805,1727,64,resign,black,78,C00,French Defense: Knight Variation
1132,1107,16,resign,black,25,C00,French Defense: Knight Variation
1696,1527,84,time,black,169,C00,French Defense: Knight Variation
1169,1104,60,mate,black,65,C00,French Defense: Knight Variation
1507,1494,46,resign,black,13,C00,French Defense: Knight Variation
1799,2193,46,resign,black,394,C00,French Defense: Knight Variation
1353,1485,30,resign,black,132,C00,French Defense: Knight Variation
1375,1679,56,resign,black,304,C00,French Defense: Knight Variation
1495,1283,153,resign,black,212,C00,French Defense: Knight Variation
2135,2118,64,resign,black,17,C00,French Defense: Knight Variation
1331,2043,46,resign,black,712,C00,French Defense: Knight Variation
1658,1835,48,mate,black,177,C00,French Defense: Knight Variation
1381,1731,66,mate,black,350,C00,French Defense: Knight Variation
1696,1695,42,resign,black,1,C00,French Defense: Knight Variation
1696,1854,76,resign,black,158,C00,French Defense: Knight Variation
1701,1662,48,resign,black,39,C00,French Defense: Knight Variation
1451,1294,58,mate,black,157,C00,French Defense: Knight Variation
1380,1251,18,resign,black,129,C00,French Defense: Knight Variation
1655,1673,62,mate,black,18,C00,French Defense: Knight Variation
1548,1465,102,resign,black,83,C00,French Defense: Knight Variation
1385,1277,125,resign,black,108,C00,French Defense: Knight Variation
1028,1212,38,mate,black,184,C00,French Defense: Knight Variation
1587,1604,112,mate,black,17,C00,French Defense: Knight Variation
1520,1595,49,resign,black,75,C00,French Defense: Knight Variation
1743,1616,32,resign,black,127,C00,French Defense: Knight Variation
1316,1586,94,resign,black,270,C00,French Defense: Knight Variation
1927,1718,102,mate,black,209,C00,French Defense: Knight Variation
1426,1764,108,mate,black,338,C00,French Defense: Knight Variation
1650,1800,112,resign,black,150,C00,French Defense: Knight Variation
1349,1653,98,resign,black,304,C00,French Defense: Knight Variation
1795,2215,94,resign,black,420,C00,French Defense: Knight Variation
1787,2194,56,resign,black,407,C00,French Defense: Knight Variation
1849,1968,80,resign,black,119,C00,French Defense: Knight Variation
1768,1560,64,mate,black,208,C00,French Defense: La Bourdonnais Variation
1856,2171,106,resign,black,315,C00,French Defense: La Bourdonnais Variation
1150,1157,92,resign,black,7,C00,French Defense: La Bourdonnais Variation
795,1157,144,resign,black,362,C00,French Defense: La Bourdonnais Variation
1663,1631,56,resign,black,32,C00,French Defense: La Bourdonnais Variation
2092,2080,110,time,black,12,C00,French Defense: La Bourdonnais Variation
1533,1511,56,resign,black,22,C00,French Defense: La Bourdonnais Variation
1446,1237,80,mate,black,209,C00,French Defense: La Bourdonnais Variation
1781,1598,46,resign,black,183,C00,French Defense: La Bourdonnais Variation
1615,1727,22,resign,black,112,C00,French Defense: La Bourdonnais Variation
1820,2225,28,resign,black,405,C00,French Defense: La Bourdonnais Variation
1534,1510,24,resign,black,24,C00,French Defense: La Bourdonnais Variation |  Reuter Gambit
1813,1887,26,resign,black,74,C12,French Defense: MacCutcheon Variation |  Chigorin Variation
1861,1960,43,resign,black,99,C12,French Defense: MacCutcheon Variation |  Chigorin Variation
2267,1500,166,mate,black,767,C12,French Defense: MacCutcheon Variation |  Exchange Variation
1694,1692,71,resign,black,2,C10,French Defense: Marshall Variation
1376,1370,46,mate,black,6,C10,French Defense: Marshall Variation
1337,1384,40,resign,black,47,C10,French Defense: Marshall Variation
1557,1675,39,resign,black,118,C10,French Defense: Marshall Variation
1201,1230,96,mate,black,29,C10,French Defense: Marshall Variation
1285,1869,44,mate,black,584,C10,French Defense: Marshall Variation
1362,1697,60,mate,black,335,C10,French Defense: Marshall Variation
1142,1431,90,mate,black,289,C01,French Defense: Mediterranean Defense
1555,1673,58,resign,black,118,C01,French Defense: Mediterranean Defense
1331,1267,82,time,black,64,C01,French Defense: Mediterranean Defense
1560,1430,43,resign,black,130,C01,French Defense: Mediterranean Defense
1305,1293,10,mate,black,12,C00,French Defense: Normal Variation
1707,1699,84,time,black,8,C00,French Defense: Normal Variation
1858,1730,49,resign,black,128,C00,French Defense: Normal Variation
1277,1173,100,time,black,104,C00,French Defense: Normal Variation
1403,1387,56,resign,black,16,C00,French Defense: Normal Variation
1437,1635,88,mate,black,198,C00,French Defense: Normal Variation
951,955,8,resign,black,4,C00,French Defense: Normal Variation
1423,1576,6,resign,black,153,C00,French Defense: Normal Variation
1479,1387,19,resign,black,92,C00,French Defense: Normal Variation
1423,1576,6,resign,black,153,C00,French Defense: Normal Variation
1421,1278,12,resign,black,143,C00,French Defense: Normal Variation
1538,1564,94,resign,black,26,C00,French Defense: Normal Variation
1868,1675,94,resign,black,193,C00,French Defense: Normal Variation
1512,1447,144,mate,black,65,C00,French Defense: Normal Variation
996,1191,94,time,black,195,C00,French Defense: Normal Variation
1941,1605,54,resign,black,336,C00,French Defense: Normal Variation
1768,1743,88,resign,black,25,C00,French Defense: Normal Variation
1754,1746,66,resign,black,8,C00,French Defense: Normal Variation
1418,1421,72,mate,black,3,C00,French Defense: Normal Variation
1199,1359,54,mate,black,160,C00,French Defense: Normal Variation
1049,1234,56,mate,black,185,C10,French Defense: Paulsen Variation
998,937,80,time,black,61,C00,French Defense: Pelikan Variation
1500,1554,78,resign,black,54,C00,French Defense: Queen's Knight
1534,1740,90,mate,black,206,C00,French Defense: Queen's Knight
1023,1086,22,resign,black,63,C00,French Defense: Queen's Knight
1500,1331,52,mate,black,169,C00,French Defense: Queen's Knight
1126,1483,60,resign,black,357,C00,French Defense: Queen's Knight
1314,1675,68,resign,black,361,C00,French Defense: Queen's Knight
1305,1229,42,resign,black,76,C00,French Defense: Queen's Knight
1278,1316,80,resign,black,38,C00,French Defense: Queen's Knight
1407,1555,114,resign,black,148,C00,French Defense: Queen's Knight
1948,1842,50,resign,black,106,C00,French Defense: Reti-Spielmann Attack
1953,1957,92,resign,black,4,C00,French Defense: Reti-Spielmann Attack
1949,2260,34,resign,black,311,C00,French Defense: Reti-Spielmann Attack
1954,2082,72,resign,black,128,C00,French Defense: Reti-Spielmann Attack
1641,1766,50,mate,black,125,C10,French Defense: Rubinstein Variation
1971,1858,156,time,black,113,C10,French Defense: Rubinstein Variation |  Blackburne Defense
1354,1631,122,mate,black,277,C00,French Defense: Schlechter Variation
1789,1838,74,time,black,49,C00,French Defense: Schlechter Variation
1323,1334,58,resign,black,11,C00,French Defense: Schlechter Variation
1289,1686,20,resign,black,397,C00,French Defense: Schlechter Variation
1490,1709,40,resign,black,219,C00,French Defense: Steiner Variation
1635,2131,22,mate,black,496,C00,French Defense: Steinitz Attack
1888,1846,58,resign,black,42,C00,French Defense: Steinitz Attack
1652,1653,46,mate,black,1,C00,French Defense: Steinitz Attack
1489,1504,82,mate,black,15,C00,French Defense: Steinitz Attack
1278,1488,54,mate,black,210,C00,French Defense: Steinitz Attack
1877,1558,50,resign,black,319,C11,French Defense: Steinitz Variation #2
1563,1498,94,resign,black,65,C03,French Defense: Tarrasch Variation
1932,1757,72,mate,black,175,C03,French Defense: Tarrasch Variation
1872,1777,56,resign,black,95,C03,French Defense: Tarrasch Variation
1766,1819,124,resign,black,53,C05,French Defense: Tarrasch Variation |  Closed Variation
2120,2135,46,time,black,15,C05,French Defense: Tarrasch Variation |  Closed Variation
2106,2241,88,time,black,135,C05,French Defense: Tarrasch Variation |  Closed Variation
1865,1850,78,mate,black,15,C05,French Defense: Tarrasch Variation |  Closed Variation #2
1392,1684,60,mate,black,292,C07,French Defense: Tarrasch Variation |  Open System
1707,1712,24,resign,black,5,C07,French Defense: Tarrasch Variation |  Open System |  Suechting Line
1114,1027,110,time,black,87,C00,French Defense: Two Knights Variation
1500,1591,22,resign,black,91,C00,French Defense: Two Knights Variation
1500,1473,32,mate,black,27,C00,French Defense: Two Knights Variation
2021,2107,36,resign,black,86,C00,French Defense: Two Knights Variation
1803,2285,50,resign,black,482,C00,French Defense: Two Knights Variation
1431,1510,50,time,black,79,C00,French Defense: Two Knights Variation
2226,2342,28,resign,black,116,C16,French Defense: Winawer Variation |  Advance Variation
1968,2344,114,mate,black,376,C16,French Defense: Winawer Variation |  Advance Variation
1998,1880,62,resign,black,118,C18,French Defense: Winawer Variation |  Advance Variation #2
1877,1813,92,resign,black,64,C01,French Defense: Winawer Variation |  Delayed Exchange Variation
1616,1673,42,mate,black,57,C01,French Defense: Winawer Variation |  Delayed Exchange Variation
1567,1698,88,resign,black,131,C15,French Defense: Winawer Variation |  Fingerslip Variation
1573,1407,30,resign,black,166,C15,French Defense: Winawer Variation |  Fingerslip Variation
2016,2264,46,mate,black,248,C18,French Defense: Winawer Variation |  Poisoned Pawn Variation
2078,2077,96,resign,black,1,C18,French Defense: Winawer Variation |  Poisoned Pawn Variation
1109,1171,16,resign,black,62,C15,French Defense: Winawer Variation |  Winckelmann-Riemer Gambit
1924,1512,14,resign,black,412,C15,French Defense: Winawer Variation |  Winckelmann-Riemer Gambit
1610,1856,102,mate,black,246,C00,French Defense: Wing Gambit
1651,2206,74,time,black,555,A00,Gedult's Opening
1477,1484,94,mate,black,7,A00,Gedult's Opening
1771,2019,106,resign,black,248,A00,Gedult's Opening
1089,1165,40,mate,black,76,C50,Giuoco Piano
1133,1234,60,resign,black,101,C50,Giuoco Piano
1750,1741,36,mate,black,9,C50,Giuoco Piano
2344,2215,50,resign,black,129,C50,Giuoco Piano
1312,1237,42,resign,black,75,C50,Giuoco Piano
1327,1343,66,resign,black,16,C50,Giuoco Piano
1798,1848,48,resign,black,50,C50,Giuoco Piano
1788,1853,62,mate,black,65,C50,Giuoco Piano
1392,1816,37,resign,black,424,C50,Giuoco Piano
1600,1545,38,resign,black,55,C50,Giuoco Piano
1588,1674,102,mate,black,86,C50,Giuoco Piano
1470,1528,42,mate,black,58,C50,Giuoco Piano
1394,1475,138,mate,black,81,C50,Giuoco Piano
1158,1521,40,time,black,363,C50,Giuoco Piano
1420,1964,40,mate,black,544,C50,Giuoco Piano
1438,1698,42,mate,black,260,C50,Giuoco Piano
1593,1654,78,time,black,61,C50,Giuoco Piano
1657,1927,58,time,black,270,C50,Giuoco Piano
1590,1614,36,resign,black,24,C50,Giuoco Piano
1445,1649,105,resign,black,204,C50,Giuoco Piano
1471,1509,24,resign,black,38,C50,Giuoco Piano
1567,1518,30,resign,black,49,C50,Giuoco Piano
1621,1855,38,resign,black,234,C50,Giuoco Piano
1533,1435,52,mate,black,98,C50,Giuoco Piano
1356,1355,76,resign,black,1,B00,Goldsmith Defense
1430,1250,52,resign,black,180,B00,Goldsmith Defense
1271,1349,30,resign,black,78,B00,Goldsmith Defense
1212,1331,50,resign,black,119,B00,Goldsmith Defense
1147,908,64,resign,black,239,B00,Goldsmith Defense: Picklepuss Defense
1531,1473,70,time,black,58,A00,Grob Opening
1016,1429,48,mate,black,413,A00,Grob Opening
1500,1250,76,mate,black,250,A00,Grob Opening
1807,1274,12,resign,black,533,A00,Grob Opening: Grob Gambit
1743,2088,98,mate,black,345,A00,Grob Opening: Grob Gambit
2066,2180,132,time,black,114,A00,Grob Opening: Grob Gambit |  Fritz Gambit
1735,1806,46,resign,black,71,D80,Gruenfeld Defense
1841,1914,168,resign,black,73,D80,Gruenfeld Defense
1368,1918,38,mate,black,550,D85,Gruenfeld Defense: Exchange Variation |  Modern Exchange Variation
1835,2307,74,resign,black,472,D94,Gruenfeld Defense: Three Knights Variation |  Burille Variation
1589,1569,120,mate,black,20,D92,Gruenfeld Defense: Three Knights Variation |  Hungarian Attack
1305,1611,57,resign,black,306,D94,Gruenfeld Defense: Three Knights Variation |  Paris Variation
1871,1865,30,resign,black,6,D91,Gruenfeld Defense: Three Knights Variation |  Petrosian System
1156,1440,70,resign,black,284,C40,Gunderam Defense
1604,1306,89,resign,black,298,C40,Gunderam Defense
1047,1492,27,resign,black,445,B00,Hippopotamus Defense #2
1578,1605,32,resign,black,27,A40,Horwitz Defense
1668,1761,54,mate,black,93,A40,Horwitz Defense
1709,1681,58,mate,black,28,A40,Horwitz Defense
1983,2313,38,resign,black,330,A40,Horwitz Defense
1057,1240,44,resign,black,183,A40,Horwitz Defense
1154,1191,7,resign,black,37,A40,Horwitz Defense
2179,2090,124,resign,black,89,A40,Horwitz Defense
1287,1355,90,resign,black,68,A40,Horwitz Defense
1500,1500,3,resign,black,0,A40,Horwitz Defense
1513,1783,16,resign,black,270,A40,Horwitz Defense
1500,1500,3,resign,black,0,A40,Horwitz Defense
1253,1956,86,resign,black,703,A40,Horwitz Defense
1265,1720,70,resign,black,455,A40,Horwitz Defense
1482,1472,34,resign,black,10,A40,Horwitz Defense
1084,1146,82,mate,black,62,A40,Horwitz Defense
1669,1481,56,mate,black,188,A40,Horwitz Defense
1255,1815,44,resign,black,560,A40,Horwitz Defense
1217,1219,30,time,black,2,A40,Horwitz Defense
1847,1835,41,resign,black,12,A40,Horwitz Defense
1853,1778,86,mate,black,75,A40,Horwitz Defense
1857,1565,84,time,black,292,A40,Horwitz Defense
1893,1830,60,resign,black,63,A40,Horwitz Defense
1408,1374,104,mate,black,34,A40,Horwitz Defense
1348,1573,46,mate,black,225,A40,Horwitz Defense
1277,1803,38,resign,black,526,A40,Horwitz Defense
1619,1595,54,resign,black,24,A40,Horwitz Defense
982,1115,32,mate,black,133,A40,Horwitz Defense
992,1017,52,resign,black,25,A40,Horwitz Defense
1390,1435,90,time,black,45,A40,Horwitz Defense
2046,2011,136,time,black,35,A40,Horwitz Defense
1870,1826,66,resign,black,44,A40,Horwitz Defense
2278,1800,38,resign,black,478,A40,Horwitz Defense
1726,1582,142,mate,black,144,A40,Horwitz Defense
1407,1333,106,resign,black,74,A40,Horwitz Defense
1545,1658,45,resign,black,113,A40,Horwitz Defense
1754,1263,36,time,black,491,A40,Horwitz Defense
1599,1716,44,resign,black,117,A40,Horwitz Defense
1834,1723,78,time,black,111,A40,Horwitz Defense
1777,1853,94,resign,black,76,A40,Horwitz Defense
1758,1718,79,resign,black,40,A40,Horwitz Defense
1450,1532,95,resign,black,82,A40,Horwitz Defense
1458,1521,70,mate,black,63,A40,Horwitz Defense
1623,1530,102,resign,black,93,A40,Horwitz Defense
1121,1212,62,mate,black,91,A40,Horwitz Defense
1290,1270,96,resign,black,20,A00,Hungarian Opening
1377,1667,50,mate,black,290,A00,Hungarian Opening
1250,1156,74,mate,black,94,A00,Hungarian Opening
1299,1513,68,mate,black,214,A00,Hungarian Opening
1464,1413,56,resign,black,51,A00,Hungarian Opening
2179,2115,78,resign,black,64,A00,Hungarian Opening
999,1092,62,resign,black,93,A00,Hungarian Opening
1029,914,20,mate,black,115,A00,Hungarian Opening
1232,1371,52,resign,black,139,A00,Hungarian Opening
1763,1628,32,resign,black,135,A00,Hungarian Opening
1464,1355,1,resign,black,109,A00,Hungarian Opening
1673,1633,88,mate,black,40,A00,Hungarian Opening
1513,1695,24,resign,black,182,A00,Hungarian Opening
1188,1605,88,resign,black,417,A00,Hungarian Opening
1162,1242,40,resign,black,80,A00,Hungarian Opening
1538,1556,72,mate,black,18,A00,Hungarian Opening
1381,1772,116,mate,black,391,A00,Hungarian Opening
1390,1730,65,resign,black,340,A00,Hungarian Opening
1496,1543,77,resign,black,47,A00,Hungarian Opening
1495,1608,62,mate,black,113,A00,Hungarian Opening
1405,1511,60,mate,black,106,A00,Hungarian Opening
1431,1800,30,mate,black,369,A00,Hungarian Opening
1359,1806,54,mate,black,447,A00,Hungarian Opening
1421,1371,32,mate,black,50,A00,Hungarian Opening
1054,1373,26,resign,black,319,A00,Hungarian Opening
1576,1636,8,resign,black,60,A00,Hungarian Opening: Buecker Gambit
1713,1558,114,mate,black,155,A00,Hungarian Opening: Indian Defense
1956,2093,108,mate,black,137,A00,Hungarian Opening: Indian Defense
1802,1709,60,time,black,93,A00,Hungarian Opening: Indian Defense
1629,1629,18,resign,black,0,A00,Hungarian Opening: Indian Defense
1283,1392,50,time,black,109,A00,Hungarian Opening: Reversed Alekhine
1499,1857,88,mate,black,358,A00,Hungarian Opening: Reversed Modern Defense
1458,1980,41,resign,black,522,A00,Hungarian Opening: Slav Formation
1858,1903,128,mate,black,45,A00,Hungarian Opening: Slav Formation
1530,1484,44,resign,black,46,A00,Hungarian Opening: Slav Formation
1494,1215,60,mate,black,279,A00,Hungarian Opening: Slav Formation
1136,843,60,mate,black,293,A00,Hungarian Opening: Symmetrical Variation
1488,2192,60,resign,black,704,A45,Indian Game
1500,1501,36,mate,black,1,A45,Indian Game
1495,1771,34,resign,black,276,A45,Indian Game
1277,1464,73,resign,black,187,A45,Indian Game
1726,1946,122,resign,black,220,A45,Indian Game
1543,1536,78,mate,black,7,A45,Indian Game
1972,1959,150,mate,black,13,A45,Indian Game
1928,1988,62,mate,black,60,A45,Indian Game
1814,1878,66,resign,black,64,A45,Indian Game
1916,1907,40,resign,black,9,A45,Indian Game
1298,1695,44,mate,black,397,A45,Indian Game
1791,1867,74,time,black,76,A45,Indian Game
1435,1456,156,time,black,21,A45,Indian Game
1068,1822,40,mate,black,754,A45,Indian Game
1460,1591,92,mate,black,131,A45,Indian Game
1885,1952,76,resign,black,67,A45,Indian Game
1603,1727,114,mate,black,124,A45,Indian Game
1751,1744,88,mate,black,7,A45,Indian Game
1847,1712,62,resign,black,135,A45,Indian Game
1984,1990,116,time,black,6,A45,Indian Game
1718,1941,126,time,black,223,A45,Indian Game
1622,2212,40,resign,black,590,A45,Indian Game
1784,1784,70,resign,black,0,A45,Indian Game
1492,1553,58,mate,black,61,A45,Indian Game
1434,1383,56,resign,black,51,A45,Indian Game
1607,1771,66,mate,black,164,A45,Indian Game
1619,1593,90,resign,black,26,A45,Indian Game
1033,1333,68,mate,black,300,E60,Indian Game: Anti-Gruenfeld |  Advance Variation
1548,1549,52,resign,black,1,A51,Indian Game: Budapest Defense
1579,1841,48,resign,black,262,E00,Indian Game: East Indian Defense
1796,2235,34,resign,black,439,E00,Indian Game: East Indian Defense
1807,2205,26,resign,black,398,E00,Indian Game: East Indian Defense
1358,1532,76,mate,black,174,E00,Indian Game: East Indian Defense
1755,1672,76,resign,black,83,E00,Indian Game: East Indian Defense
1233,1932,114,mate,black,699,E00,Indian Game: East Indian Defense
1367,1450,64,time,black,83,A46,Indian Game: London System
1944,1928,94,mate,black,16,A46,Indian Game: London System
1670,1848,40,resign,black,178,A46,Indian Game: London System
1519,1557,72,resign,black,38,A45,Indian Game: Pawn Push Variation
1423,1453,42,resign,black,30,A45,Indian Game: Pawn Push Variation
1605,1710,88,mate,black,105,E00,Indian Game: Seirawan Attack
2054,2089,48,resign,black,35,A46,Indian Game: Spielmann-Indian
1496,1861,45,resign,black,365,A45,Indian Game: Tartakower Attack
1539,1397,58,mate,black,142,A45,Indian Game: Tartakower Attack
1808,1752,84,resign,black,56,A45,Indian Game: Tartakower Attack
2006,1956,70,resign,black,50,A46,Indian Game: Wade-Tartakower Defense
1377,1738,44,mate,black,361,A46,Indian Game: Wade-Tartakower Defense
1375,1671,49,resign,black,296,E61,Indian Game: West Indian Defense
1722,1592,104,mate,black,130,E61,Indian Game: West Indian Defense
1500,1676,90,mate,black,176,E61,Indian Game: West Indian Defense
1254,1353,6,resign,black,99,C44,Irish Gambit
1297,1313,50,mate,black,16,C50,Italian Game
1645,1655,69,resign,black,10,C50,Italian Game
1755,1717,94,mate,black,38,C50,Italian Game
1748,1647,60,resign,black,101,C50,Italian Game
1384,1353,22,mate,black,31,C50,Italian Game
1760,1358,22,mate,black,402,C50,Italian Game
1359,1218,41,resign,black,141,C50,Italian Game
1172,1162,34,time,black,10,C50,Italian Game
1348,1756,8,resign,black,408,C50,Italian Game
1361,1430,38,mate,black,69,C50,Italian Game
1386,1285,24,resign,black,101,C50,Italian Game
1222,1234,76,mate,black,12,C50,Italian Game
1536,1796,58,resign,black,260,C50,Italian Game
1474,1839,118,resign,black,365,C50,Italian Game
1424,1421,67,resign,black,3,C50,Italian Game
1750,1660,68,mate,black,90,C50,Italian Game
1234,1359,26,mate,black,125,C55,Italian Game: Anti-Fried Liver Defense
1861,1844,76,resign,black,17,C55,Italian Game: Anti-Fried Liver Defense
1844,1793,56,mate,black,51,C55,Italian Game: Anti-Fried Liver Defense
1388,1238,94,time,black,150,C55,Italian Game: Anti-Fried Liver Defense
1423,1610,40,resign,black,187,C55,Italian Game: Anti-Fried Liver Defense
1343,1369,18,resign,black,26,C55,Italian Game: Anti-Fried Liver Defense
1233,1503,28,resign,black,270,C55,Italian Game: Anti-Fried Liver Defense
1717,1618,62,time,black,99,C55,Italian Game: Anti-Fried Liver Defense
1518,1689,10,time,black,171,C55,Italian Game: Anti-Fried Liver Defense
1408,1577,48,mate,black,169,C55,Italian Game: Anti-Fried Liver Defense
1425,1447,64,mate,black,22,C55,Italian Game: Anti-Fried Liver Defense
1461,1491,100,time,black,30,C55,Italian Game: Anti-Fried Liver Defense
1464,1415,36,resign,black,49,C55,Italian Game: Anti-Fried Liver Defense
1498,1768,42,resign,black,270,C55,Italian Game: Anti-Fried Liver Defense
1551,1574,170,mate,black,23,C55,Italian Game: Anti-Fried Liver Defense
1399,1483,30,resign,black,84,C55,Italian Game: Anti-Fried Liver Defense
1559,1767,40,mate,black,208,C55,Italian Game: Anti-Fried Liver Defense
1094,1047,62,resign,black,47,C55,Italian Game: Anti-Fried Liver Defense
1519,1547,96,mate,black,28,C55,Italian Game: Anti-Fried Liver Defense
1687,1557,74,resign,black,130,C55,Italian Game: Anti-Fried Liver Defense
1699,1706,64,mate,black,7,C55,Italian Game: Anti-Fried Liver Defense
1312,1448,48,resign,black,136,C55,Italian Game: Anti-Fried Liver Defense
1588,1554,42,mate,black,34,C55,Italian Game: Anti-Fried Liver Defense
1801,1717,50,resign,black,84,C55,Italian Game: Anti-Fried Liver Defense
1536,1353,28,resign,black,183,C55,Italian Game: Anti-Fried Liver Defense
1392,1542,122,mate,black,150,C55,Italian Game: Anti-Fried Liver Defense
1404,1554,46,mate,black,150,C55,Italian Game: Anti-Fried Liver Defense
1144,1384,48,mate,black,240,C55,Italian Game: Anti-Fried Liver Defense
1327,1450,24,resign,black,123,C55,Italian Game: Anti-Fried Liver Defense
1607,1813,52,mate,black,206,C55,Italian Game: Anti-Fried Liver Defense
1393,1539,16,resign,black,146,C55,Italian Game: Anti-Fried Liver Defense
1720,1697,96,time,black,23,C53,Italian Game: Classical Variation #2
1906,2058,62,mate,black,152,C53,Italian Game: Classical Variation #2
1965,2077,114,time,black,112,C53,Italian Game: Classical Variation #2
1300,1495,46,mate,black,195,C53,Italian Game: Classical Variation |  Center Attack
1500,1989,54,mate,black,489,C53,Italian Game: Classical Variation |  Center Holding Variation
1636,1619,34,mate,black,17,C53,Italian Game: Classical Variation |  Closed Variation
1453,1369,40,resign,black,84,C53,Italian Game: Classical Variation |  Giuoco Pianissimo
1464,1465,114,resign,black,1,C53,Italian Game: Classical Variation |  Giuoco Pianissimo
2082,2144,54,resign,black,62,C53,Italian Game: Classical Variation |  Giuoco Pianissimo
1247,1702,58,resign,black,455,C53,Italian Game: Classical Variation |  Giuoco Pianissimo
1968,1882,72,mate,black,86,C54,Italian Game: Classical Variation |  Greco Gambit |  Main Line
1774,1965,118,mate,black,191,C54,Italian Game: Classical Variation |  Greco Gambit |  Traditional Line
1850,1811,86,resign,black,39,C55,Italian Game: Deutz Gambit
1533,1550,46,resign,black,17,C51,Italian Game: Evans Gambit Declined
1508,1469,31,resign,black,39,C51,Italian Game: Evans Gambit Declined
1651,1974,29,resign,black,323,C51,Italian Game: Evans Gambit Declined |  5.a4
1406,1512,64,time,black,106,C51,Italian Game: Evans Gambit |  McDonnell Defense
1698,1680,72,resign,black,18,C51,Italian Game: Evans Gambit |  McDonnell Defense
1588,1619,114,time,black,31,C52,Italian Game: Evans Gambit |  Slow Variation
1744,1770,92,mate,black,26,C50,Italian Game: Giuoco Pianissimo
1328,1978,46,mate,black,650,C50,Italian Game: Giuoco Pianissimo
1350,1938,38,resign,black,588,C50,Italian Game: Giuoco Pianissimo
1360,1873,50,resign,black,513,C50,Italian Game: Giuoco Pianissimo
1316,1298,14,mate,black,18,C50,Italian Game: Giuoco Pianissimo
1504,1558,62,resign,black,54,C50,Italian Game: Giuoco Pianissimo
1385,1526,40,resign,black,141,C50,Italian Game: Giuoco Pianissimo
1484,1760,42,mate,black,276,C50,Italian Game: Giuoco Pianissimo
1442,1449,52,mate,black,7,C50,Italian Game: Giuoco Pianissimo
1461,1486,52,resign,black,25,C50,Italian Game: Giuoco Pianissimo |  Canal Variation
1687,1993,68,resign,black,306,C50,Italian Game: Giuoco Pianissimo |  Canal Variation
1395,1378,46,mate,black,17,C50,Italian Game: Giuoco Pianissimo |  Italian Four Knights Variation
1611,1591,40,mate,black,20,C50,Italian Game: Giuoco Pianissimo |  Italian Four Knights Variation
1533,1624,38,mate,black,91,C50,Italian Game: Giuoco Pianissimo |  Italian Four Knights Variation
2232,2081,72,time,black,151,C50,Italian Game: Giuoco Pianissimo |  Italian Four Knights Variation
1574,1853,85,resign,black,279,C50,Italian Game: Giuoco Pianissimo |  Italian Four Knights Variation
1338,1541,12,time,black,203,C50,Italian Game: Giuoco Pianissimo |  Italian Four Knights Variation
1294,1804,50,mate,black,510,C50,Italian Game: Giuoco Pianissimo |  Italian Four Knights Variation
1813,1602,24,mate,black,211,C50,Italian Game: Giuoco Pianissimo |  Italian Four Knights Variation
1713,1658,54,resign,black,55,C50,Italian Game: Giuoco Pianissimo |  Italian Four Knights Variation
1679,1692,24,resign,black,13,C50,Italian Game: Giuoco Pianissimo |  Italian Four Knights Variation
1487,1729,39,resign,black,242,C50,Italian Game: Giuoco Pianissimo |  Italian Four Knights Variation
1654,1515,82,resign,black,139,C50,Italian Game: Giuoco Pianissimo |  Italian Four Knights Variation
1386,1288,48,resign,black,98,C50,Italian Game: Giuoco Pianissimo |  Italian Four Knights Variation
1320,1336,74,time,black,16,C50,Italian Game: Giuoco Pianissimo |  Italian Four Knights Variation
1380,1252,18,mate,black,128,C50,Italian Game: Giuoco Pianissimo |  Italian Four Knights Variation
1757,1667,92,mate,black,90,C50,Italian Game: Giuoco Pianissimo |  Italian Four Knights Variation
2151,2029,82,resign,black,122,C50,Italian Game: Giuoco Pianissimo |  Normal
1273,1286,26,mate,black,13,C50,Italian Game: Giuoco Pianissimo |  Normal
1412,1433,50,mate,black,21,C50,Italian Game: Giuoco Pianissimo |  Normal
1246,1759,46,resign,black,513,C50,Italian Game: Giuoco Pianissimo |  Normal
1467,1390,32,resign,black,77,C50,Italian Game: Giuoco Pianissimo |  Normal
1777,1648,38,resign,black,129,C50,Italian Game: Giuoco Pianissimo |  Normal
1901,1629,26,resign,black,272,C50,Italian Game: Giuoco Pianissimo |  Normal
1411,1177,96,mate,black,234,C50,Italian Game: Giuoco Pianissimo |  Normal
1296,1305,18,resign,black,9,C54,Italian Game: Giuoco Piano |  Greco's Attack
1522,1727,114,mate,black,205,C54,Italian Game: Giuoco Piano |  Greco's Attack
1763,1661,112,mate,black,102,C54,Italian Game: Giuoco Piano |  Greco's Attack
1597,1670,80,resign,black,73,C54,Italian Game: Giuoco Piano |  Greco's Attack
1505,1542,47,resign,black,37,C54,Italian Game: Giuoco Piano |  Greco's Attack
1627,1495,108,resign,black,132,C50,Italian Game: Hungarian Defense
1007,1268,32,resign,black,261,C50,Italian Game: Hungarian Defense
1941,1925,114,resign,black,16,C50,Italian Game: Hungarian Defense
1545,1684,76,time,black,139,C50,Italian Game: Hungarian Defense
1212,1743,16,resign,black,531,C50,Italian Game: Hungarian Defense
1278,1329,54,mate,black,51,C51,Italian Game: Jerome Gambit
951,1367,45,resign,black,416,C50,Italian Game: Rosentreter Gambit
972,985,96,mate,black,13,C50,Italian Game: Rousseau Gambit
1223,1286,44,mate,black,63,C50,Italian Game: Rousseau Gambit
1439,1392,66,resign,black,47,C50,Italian Game: Schilling-Kostic Gambit
1490,1440,14,mate,black,50,C50,Italian Game: Schilling-Kostic Gambit
1862,1556,34,mate,black,306,C50,Italian Game: Schilling-Kostic Gambit
1562,1556,82,resign,black,6,C50,Italian Game: Schilling-Kostic Gambit
1547,1513,40,mate,black,34,C50,Italian Game: Schilling-Kostic Gambit
1669,1717,14,resign,black,48,C50,Italian Game: Schilling-Kostic Gambit
932,1389,78,mate,black,457,C50,Italian Game: Schilling-Kostic Gambit
1347,1417,68,mate,black,70,C55,Italian Game: Scotch Gambit Declined
1812,1949,38,mate,black,137,C56,Italian Game: Scotch Gambit |  Anderssen Attack
1844,1731,76,mate,black,113,C55,Italian Game: Scotch Gambit |  Janowski Defense
1429,1333,26,resign,black,96,C55,Italian Game: Scotch Gambit |  Walbrodt-Baird Gambit
1728,1500,14,resign,black,228,C55,Italian Game: Two Knights Defense
1055,1569,57,resign,black,514,C55,Italian Game: Two Knights Defense
1671,1709,90,time,black,38,C55,Italian Game: Two Knights Defense
1089,1152,52,mate,black,63,C55,Italian Game: Two Knights Defense
1638,1574,54,resign,black,64,C55,Italian Game: Two Knights Defense #2
1220,1341,36,mate,black,121,C57,Italian Game: Two Knights Defense |  Fried Liver Attack
1275,1236,62,resign,black,39,C57,Italian Game: Two Knights Defense |  Fried Liver Attack
1633,1625,80,resign,black,8,C57,Italian Game: Two Knights Defense |  Fried Liver Attack
1741,1860,68,mate,black,119,C57,Italian Game: Two Knights Defense |  Fried Liver Attack
1612,1561,136,mate,black,51,C57,Italian Game: Two Knights Defense |  Fried Liver Attack
1318,1448,30,resign,black,130,C57,Italian Game: Two Knights Defense |  Fritz Variation
1550,1531,28,resign,black,19,C57,Italian Game: Two Knights Defense |  Fritz Variation
1250,1243,44,mate,black,7,C57,Italian Game: Two Knights Defense |  Knight Attack
1410,1629,128,mate,black,219,C57,Italian Game: Two Knights Defense |  Knight Attack |  Normal Variation
1349,1534,36,resign,black,185,C57,Italian Game: Two Knights Defense |  Knight Attack |  Normal Variation
1550,1372,104,mate,black,178,C57,Italian Game: Two Knights Defense |  Knight Attack |  Normal Variation
1207,1190,18,resign,black,17,C57,Italian Game: Two Knights Defense |  Knight Attack |  Normal Variation
1248,1417,46,resign,black,169,C57,Italian Game: Two Knights Defense |  Knight Attack |  Normal Variation
1730,1473,38,mate,black,257,C57,Italian Game: Two Knights Defense |  Knight Attack |  Normal Variation
1305,1293,28,resign,black,12,C57,Italian Game: Two Knights Defense |  Knight Attack |  Normal Variation
1388,1390,80,mate,black,2,C57,Italian Game: Two Knights Defense |  Lolli Attack
1355,1478,70,resign,black,123,C55,Italian Game: Two Knights Defense |  Modern Bishop's Opening
1402,1465,78,mate,black,63,C55,Italian Game: Two Knights Defense |  Modern Bishop's Opening
1305,2264,37,resign,black,959,C55,Italian Game: Two Knights Defense |  Modern Bishop's Opening
1017,1122,72,mate,black,105,C55,Italian Game: Two Knights Defense |  Modern Bishop's Opening
1424,1431,114,resign,black,7,C55,Italian Game: Two Knights Defense |  Modern Bishop's Opening
1525,1385,60,mate,black,140,C55,Italian Game: Two Knights Defense |  Modern Bishop's Opening
1975,1962,80,resign,black,13,C55,Italian Game: Two Knights Defense |  Modern Bishop's Opening
1516,1643,53,resign,black,127,C55,Italian Game: Two Knights Defense |  Modern Bishop's Opening
1394,1353,54,resign,black,41,C55,Italian Game: Two Knights Defense |  Modern Bishop's Opening
1671,2266,62,resign,black,595,C55,Italian Game: Two Knights Defense |  Modern Bishop's Opening
1455,1081,62,resign,black,374,C57,Italian Game: Two Knights Defense |  Polerio Defense
1370,1469,44,resign,black,99,C57,Italian Game: Two Knights Defense |  Polerio Defense
1405,2016,58,mate,black,611,C58,Italian Game: Two Knights Defense |  Polerio Defense |  Bishop Check Line
1434,1449,42,mate,black,15,C58,Italian Game: Two Knights Defense |  Polerio Defense |  Bishop Check Line
1615,1627,150,mate,black,12,C58,Italian Game: Two Knights Defense |  Polerio Defense |  Bishop Check Line
1689,1273,36,resign,black,416,C58,Italian Game: Two Knights Defense |  Polerio Defense |  Bishop Check Line
2027,2079,54,resign,black,52,C58,Italian Game: Two Knights Defense |  Polerio Defense |  Bishop Check Line
1947,2060,66,resign,black,113,C58,Italian Game: Two Knights Defense |  Polerio Defense |  Bishop Check Line
1883,1817,64,mate,black,66,C59,Italian Game: Two Knights Defense |  Steinitz Variation
1613,1617,40,mate,black,4,C57,Italian Game: Two Knights Defense |  Traxler Counterattack
1518,1516,16,mate,black,2,C57,Italian Game: Two Knights Defense |  Traxler Counterattack |  Knight Sacrifice Line
1522,1404,64,mate,black,118,C55,Italian Game: Two Knights Defense |  de Riviere Gambit
1382,1009,14,time,black,373,A00,Kadas Opening
1254,1461,120,mate,black,207,A00,Kadas Opening
961,974,66,mate,black,13,A00,Kadas Opening
1116,1376,102,resign,black,260,A00,Kadas Opening
1010,1530,23,resign,black,520,A00,Kadas Opening
1515,1127,26,mate,black,388,E00,Kangaroo Defense
1420,1620,100,resign,black,200,C30,King's Gambit
1351,1366,34,mate,black,15,C30,King's Gambit
1140,1349,62,resign,black,209,C30,King's Gambit
1028,1284,70,mate,black,256,C30,King's Gambit
1517,1535,50,mate,black,18,C30,King's Gambit
1336,1355,101,resign,black,19,C30,King's Gambit
1408,1584,82,mate,black,176,C30,King's Gambit
1305,1402,98,mate,black,97,C30,King's Gambit
1740,1496,81,resign,black,244,C36,King's Gambit Accepted |  Abbazia Defense
1518,1716,54,mate,black,198,C33,King's Gambit Accepted |  Bishop's Gambit
1708,1887,76,time,black,179,C33,King's Gambit Accepted |  Bishop's Gambit |  Maurian Defense
1612,1714,30,resign,black,102,C35,King's Gambit Accepted |  Cunningham Defense
1845,1949,20,resign,black,104,C35,King's Gambit Accepted |  Cunningham Defense
1602,1615,96,resign,black,13,C34,King's Gambit Accepted |  Fischer Defense
1540,1629,57,resign,black,89,C34,King's Gambit Accepted |  Fischer Defense
1130,1383,60,mate,black,253,C34,King's Gambit Accepted |  Fischer Defense
1940,1808,28,resign,black,132,C38,King's Gambit Accepted |  Greco Gambit
1860,1712,10,resign,black,148,C37,King's Gambit Accepted |  King's Knight Gambit
1066,1256,11,resign,black,190,C34,King's Gambit Accepted |  King's Knight Gambit
1479,1399,30,resign,black,80,C34,King's Gambit Accepted |  MacLeod Defense
1305,1497,56,time,black,192,C34,King's Gambit Accepted |  MacLeod Defense
1705,1599,23,resign,black,106,C34,King's Gambit Accepted |  MacLeod Defense
1788,1187,50,resign,black,601,C37,King's Gambit Accepted |  Muzio Gambit |  Sarratt Defense
1329,1308,118,mate,black,21,C33,King's Gambit Accepted |  Polerio Gambit
2207,2239,34,resign,black,32,C33,King's Gambit Accepted |  Polerio Gambit
1348,1322,19,resign,black,26,C34,King's Gambit Accepted |  Schallopp Defense
976,1226,28,resign,black,250,C34,King's Gambit Accepted |  Schallopp Defense
1910,1714,58,resign,black,196,C39,King's Gambit Accepted: Allgaier |  Schlechter Defense
1821,1979,76,resign,black,158,C36,King's Gambit Accepted: Modern Defense #2
1890,2139,132,mate,black,249,C30,King's Gambit Declined |  Classical Variation
1861,1757,36,resign,black,104,C30,King's Gambit Declined |  Mafia Defense
1683,1599,42,resign,black,84,C30,King's Gambit Declined |  Queen's Knight Defense
1073,1313,20,resign,black,240,C30,King's Gambit Declined |  Queen's Knight Defense
1004,1453,60,resign,black,449,C30,King's Gambit Declined |  Queen's Knight Defense
1423,1396,84,time,black,27,C30,King's Gambit Declined |  Queen's Knight Defense
2108,2270,16,resign,black,162,C31,King's Gambit |  Falkbeer Countergambit |  Nimzowitsch-Marshall Countergambit
2000,1908,80,resign,black,92,A08,King's Indian Attack
1869,1670,62,resign,black,199,A07,King's Indian Attack
1494,1640,154,resign,black,146,A07,King's Indian Attack
2036,1706,50,resign,black,330,A08,King's Indian Attack: French Variation
2036,1706,50,resign,black,330,A08,King's Indian Attack: French Variation
1969,2247,59,resign,black,278,A08,King's Indian Attack: Sicilian Variation
1881,1825,62,mate,black,56,A05,King's Indian Attack: Symmetrical Defense
1655,1566,70,resign,black,89,E61,King's Indian Defense
1696,1706,110,resign,black,10,E61,King's Indian Defense
1785,1489,52,mate,black,296,E61,King's Indian Defense
1952,1960,110,resign,black,8,E61,King's Indian Defense
2022,2080,51,resign,black,58,E70,King's Indian Defense: Accelerated Averbakh Variation
2145,2588,122,time,black,443,E64,King's Indian Defense: Fianchetto Variation |  Yugoslav System |  without Nc3
1535,1602,38,resign,black,67,E76,King's Indian Defense: Four Pawns Attack
1610,1750,54,resign,black,140,E76,King's Indian Defense: Four Pawns Attack |  Dynamic Attack
1988,2199,84,resign,black,211,E77,King's Indian Defense: Four Pawns Attack |  Normal Attack
1664,1626,52,resign,black,38,E90,King's Indian Defense: Larsen Variation
1708,1694,64,resign,black,14,E60,King's Indian Defense: Normal Variation |  King's Knight Variation
1945,1901,94,resign,black,44,E60,King's Indian Defense: Normal Variation |  King's Knight Variation
1783,1779,64,mate,black,4,E60,King's Indian Defense: Normal Variation |  King's Knight Variation
1692,1756,56,resign,black,64,E60,King's Indian Defense: Normal Variation |  King's Knight Variation
1387,1457,34,resign,black,70,E90,King's Indian Defense: Normal Variation |  Rare Defenses
1272,1785,150,mate,black,513,E90,King's Indian Defense: Normal Variation |  Rare Defenses
1406,1823,86,time,black,417,E90,King's Indian Defense: Normal Variation |  Rare Defenses
2030,2036,34,time,black,6,E90,King's Indian Defense: Normal Variation |  Rare Defenses
1953,1721,30,resign,black,232,E80,King's Indian Defense: Saemisch Variation
1575,1516,76,resign,black,59,E81,King's Indian Defense: Saemisch Variation |  Normal Defense
1848,1773,58,resign,black,75,E61,King's Indian Defense: Semi-Classical Variation |  Benoni Variation
1299,1369,76,mate,black,70,E77,King's Indian Defense: Six Pawns Attack
1739,1986,68,resign,black,247,E61,King's Indian Defense: Smyslov Variation
1830,2003,84,resign,black,173,E90,King's Indian Defense: Zinnowitz Variation
1696,1896,72,resign,black,200,E90,King's Indian Defense: Zinnowitz Variation
1862,1843,54,resign,black,19,E90,King's Indian Defense: Zinnowitz Variation
1226,1478,156,mate,black,252,C40,King's Knight Opening
945,1070,4,time,black,125,C40,King's Knight Opening
1363,1353,40,mate,black,10,C40,King's Knight Opening
1261,1279,32,mate,black,18,C40,King's Knight Opening
1233,1532,17,resign,black,299,C40,King's Knight Opening
1270,1279,54,mate,black,9,C40,King's Knight Opening
1548,1503,51,resign,black,45,C40,King's Knight Opening
1426,1357,56,resign,black,69,C40,King's Knight Opening
1433,1597,56,resign,black,164,C40,King's Knight Opening
1589,1588,72,resign,black,1,C40,King's Knight Opening
1580,1800,52,mate,black,220,C44,King's Knight Opening: Konstantinopolsky
1449,1729,54,resign,black,280,C44,King's Knight Opening: Konstantinopolsky
1418,1404,30,resign,black,14,C44,King's Knight Opening: Normal Variation
1138,1217,16,resign,black,79,C44,King's Knight Opening: Normal Variation
1257,1342,52,mate,black,85,C44,King's Knight Opening: Normal Variation
1311,1402,67,resign,black,91,C44,King's Knight Opening: Normal Variation
1254,1116,56,mate,black,138,C44,King's Knight Opening: Normal Variation
1500,1406,50,resign,black,94,C44,King's Knight Opening: Normal Variation
1649,1445,60,resign,black,204,C44,King's Knight Opening: Normal Variation
1476,1601,86,resign,black,125,C44,King's Knight Opening: Normal Variation
1425,1174,104,mate,black,251,C44,King's Knight Opening: Normal Variation
913,1058,13,resign,black,145,C44,King's Knight Opening: Normal Variation
1407,1326,62,mate,black,81,C44,King's Knight Opening: Normal Variation
1543,1466,4,time,black,77,C44,King's Knight Opening: Normal Variation
1810,1473,70,mate,black,337,C20,King's Pawn Game
1039,1161,2,time,black,122,C20,King's Pawn Game
1633,1287,2,time,black,346,C20,King's Pawn Game
1173,1751,30,resign,black,578,C20,King's Pawn Game
1688,1423,90,mate,black,265,C20,King's Pawn Game
1725,1451,70,time,black,274,C20,King's Pawn Game
1177,1510,42,mate,black,333,C20,King's Pawn Game
1364,1192,60,resign,black,172,C20,King's Pawn Game
1015,1007,58,mate,black,8,C20,King's Pawn Game
972,954,46,mate,black,18,C20,King's Pawn Game: Alapin Opening
1101,1635,62,mate,black,534,C20,King's Pawn Game: Alapin Opening
1408,1579,26,resign,black,171,C21,King's Pawn Game: Beyer Gambit
1236,1309,46,resign,black,73,C21,King's Pawn Game: Beyer Gambit
1371,1457,31,resign,black,86,C40,King's Pawn Game: Busch-Gass Gambit
1543,1858,24,resign,black,315,C40,King's Pawn Game: Busch-Gass Gambit
1542,1557,58,mate,black,15,C40,King's Pawn Game: Busch-Gass Gambit
1184,1346,42,resign,black,162,C40,King's Pawn Game: Busch-Gass Gambit
1218,1371,78,mate,black,153,C20,King's Pawn Game: Clam Variation |  King's Gambit Reversed
1319,1214,60,resign,black,105,C40,King's Pawn Game: Damiano Defense
1427,1433,60,resign,black,6,C40,King's Pawn Game: Damiano Defense
1059,1016,56,time,black,43,C40,King's Pawn Game: Damiano Defense
1508,1243,48,resign,black,265,C40,King's Pawn Game: Damiano Defense
1248,1342,100,mate,black,94,C40,King's Pawn Game: Damiano Defense
1129,1161,34,resign,black,32,C40,King's Pawn Game: Damiano Defense
1426,1461,102,time,black,35,C40,King's Pawn Game: Damiano Defense
1244,1297,38,mate,black,53,C40,King's Pawn Game: Damiano Defense
1127,1333,36,resign,black,206,C40,King's Pawn Game: Damiano Defense
1434,1534,54,resign,black,100,C40,King's Pawn Game: Damiano Defense
999,967,27,resign,black,32,C40,King's Pawn Game: Damiano Defense
1486,1552,40,mate,black,66,C44,King's Pawn Game: Dresden Opening
1243,1200,50,resign,black,43,C40,King's Pawn Game: Gunderam Gambit
1403,1321,38,mate,black,82,C40,King's Pawn Game: Gunderam Gambit
1356,1498,49,resign,black,142,C20,King's Pawn Game: King's Head Opening
982,1700,49,resign,black,718,C20,King's Pawn Game: King's Head Opening #2
1323,1451,54,time,black,128,C20,King's Pawn Game: King's Head Opening #2
1332,1299,24,mate,black,33,C20,King's Pawn Game: King's Head Opening #2
1042,1133,86,mate,black,91,C20,King's Pawn Game: Leonardis Variation
1302,875,88,time,black,427,C20,King's Pawn Game: Leonardis Variation
1651,1684,62,resign,black,33,C20,King's Pawn Game: Leonardis Variation
1576,1671,58,resign,black,95,C20,King's Pawn Game: Leonardis Variation
1500,1378,12,resign,black,122,C20,King's Pawn Game: Leonardis Variation
1446,1359,62,resign,black,87,C20,King's Pawn Game: Leonardis Variation
1468,1354,12,mate,black,114,C20,King's Pawn Game: Leonardis Variation
1889,1907,62,resign,black,18,C20,King's Pawn Game: Leonardis Variation
1113,1581,34,mate,black,468,C20,King's Pawn Game: Leonardis Variation
1089,1162,54,time,black,73,C20,King's Pawn Game: Leonardis Variation
1252,1770,40,resign,black,518,C20,King's Pawn Game: Leonardis Variation
1157,1211,29,resign,black,54,C20,King's Pawn Game: Leonardis Variation
1073,1939,16,mate,black,866,C20,King's Pawn Game: Leonardis Variation
1141,1098,54,mate,black,43,C20,King's Pawn Game: Leonardis Variation
1573,1877,71,resign,black,304,C20,King's Pawn Game: Leonardis Variation
1295,1153,99,resign,black,142,C20,King's Pawn Game: Leonardis Variation
1303,1354,72,resign,black,51,C20,King's Pawn Game: Leonardis Variation
1305,1462,48,resign,black,157,C20,King's Pawn Game: Leonardis Variation
1286,1328,62,mate,black,42,C20,King's Pawn Game: Leonardis Variation
1648,1698,64,time,black,50,C20,King's Pawn Game: Leonardis Variation
1484,1663,164,mate,black,179,C20,King's Pawn Game: Leonardis Variation
1459,1499,18,resign,black,40,C20,King's Pawn Game: Leonardis Variation
1473,1518,58,resign,black,45,C20,King's Pawn Game: Leonardis Variation
1454,1532,88,resign,black,78,C20,King's Pawn Game: Leonardis Variation
1407,1430,32,resign,black,23,C20,King's Pawn Game: Leonardis Variation
1485,1720,20,resign,black,235,C20,King's Pawn Game: Leonardis Variation
1340,1353,26,resign,black,13,C20,King's Pawn Game: Leonardis Variation
1503,1591,70,resign,black,88,C20,King's Pawn Game: Leonardis Variation
1360,1522,58,mate,black,162,C20,King's Pawn Game: Leonardis Variation
1628,1532,58,resign,black,96,C20,King's Pawn Game: Leonardis Variation
1930,1979,40,resign,black,49,C20,King's Pawn Game: Macleod Attack
1102,1385,56,mate,black,283,C20,King's Pawn Game: Macleod Attack
1302,1647,56,resign,black,345,C20,King's Pawn Game: Macleod Attack
1474,1328,132,resign,black,146,C20,King's Pawn Game: Macleod Attack
1029,1204,46,mate,black,175,C20,King's Pawn Game: Macleod Attack
1157,1264,32,time,black,107,C20,King's Pawn Game: Macleod Attack
1261,1371,48,mate,black,110,B07,King's Pawn Game: Maroczy Defense
924,1097,70,time,black,173,B07,King's Pawn Game: Maroczy Defense
1650,1592,26,resign,black,58,B07,King's Pawn Game: Maroczy Defense
1140,1457,36,mate,black,317,B07,King's Pawn Game: Maroczy Defense
1277,1378,46,resign,black,101,B07,King's Pawn Game: Maroczy Defense
1467,1430,74,mate,black,37,B07,King's Pawn Game: Maroczy Defense
1151,1200,44,resign,black,49,B07,King's Pawn Game: Maroczy Defense
1389,1339,29,resign,black,50,C40,King's Pawn Game: McConnell Defense
1668,1642,89,resign,black,26,C40,King's Pawn Game: McConnell Defense
1374,1385,8,time,black,11,C40,King's Pawn Game: McConnell Defense
1735,1649,80,time,black,86,C40,King's Pawn Game: McConnell Defense
1720,1566,108,mate,black,154,C40,King's Pawn Game: McConnell Defense
1408,1393,102,mate,black,15,C40,King's Pawn Game: McConnell Defense
1436,1522,42,resign,black,86,C40,King's Pawn Game: McConnell Defense
1026,1116,72,resign,black,90,C40,King's Pawn Game: McConnell Defense
1500,1311,32,resign,black,189,C40,King's Pawn Game: McConnell Defense
1077,1359,80,time,black,282,C40,King's Pawn Game: McConnell Defense
1244,1384,33,resign,black,140,C40,King's Pawn Game: McConnell Defense
1667,1659,120,time,black,8,C40,King's Pawn Game: McConnell Defense
1742,1576,54,resign,black,166,C40,King's Pawn Game: McConnell Defense
1371,1270,30,mate,black,101,C40,King's Pawn Game: McConnell Defense
1374,1351,40,resign,black,23,C40,King's Pawn Game: McConnell Defense
1161,1389,40,resign,black,228,C40,King's Pawn Game: McConnell Defense
1494,1447,48,mate,black,47,C40,King's Pawn Game: McConnell Defense
1274,1435,64,resign,black,161,C40,King's Pawn Game: McConnell Defense
1522,1360,52,time,black,162,C40,King's Pawn Game: McConnell Defense
1527,1882,18,resign,black,355,C20,King's Pawn Game: Mengarini's Opening
1545,1890,26,mate,black,345,C20,King's Pawn Game: Mengarini's Opening
1136,1128,40,mate,black,8,C20,King's Pawn Game: Napoleon Attack
1586,1632,56,mate,black,46,C20,King's Pawn Game: Napoleon Attack
1763,1816,58,mate,black,53,C20,King's Pawn Game: Napoleon Attack
1156,1005,4,time,black,151,C20,King's Pawn Game: Napoleon Attack
1698,1247,108,mate,black,451,C20,King's Pawn Game: Napoleon Attack
1778,2236,42,resign,black,458,C20,King's Pawn Game: Napoleon Attack
1178,1172,62,mate,black,6,C20,King's Pawn Game: Napoleon Attack
1209,1160,14,mate,black,49,C20,King's Pawn Game: Napoleon Attack
971,1149,118,mate,black,178,B00,King's Pawn Game: Nimzowitsch Defense
1628,1721,57,resign,black,93,B00,King's Pawn Game: Nimzowitsch Defense
1744,1681,62,resign,black,63,B00,King's Pawn Game: Nimzowitsch Defense
1430,1500,54,mate,black,70,B00,King's Pawn Game: Nimzowitsch Defense
1158,1306,64,mate,black,148,B00,King's Pawn Game: Nimzowitsch Defense
1173,1247,116,mate,black,74,B00,King's Pawn Game: Nimzowitsch Defense
1620,1462,68,resign,black,158,B00,King's Pawn Game: Nimzowitsch Defense
1206,1341,81,resign,black,135,B00,King's Pawn Game: Nimzowitsch Defense
1518,1345,94,resign,black,173,B07,King's Pawn Game: Philidor Gambit
1500,1504,46,time,black,4,C44,King's Pawn Game: Tayler Opening
1716,1422,26,mate,black,294,C44,King's Pawn Game: Tayler Opening
1654,1368,50,resign,black,286,C44,King's Pawn Game: Tayler Opening
1707,1678,62,mate,black,29,C44,King's Pawn Game: Tayler Opening
1235,1444,44,mate,black,209,C20,King's Pawn Game: Tortoise Opening
1352,1577,32,mate,black,225,C20,King's Pawn Game: Tortoise Opening
922,1120,78,resign,black,198,C20,King's Pawn Game: Wayward Queen Attack
1651,1657,150,mate,black,6,C20,King's Pawn Game: Wayward Queen Attack
1173,1262,40,resign,black,89,C20,King's Pawn Game: Wayward Queen Attack
1239,1269,104,resign,black,30,C20,King's Pawn Game: Wayward Queen Attack
1210,1183,122,time,black,27,C20,King's Pawn Game: Wayward Queen Attack
1228,1732,130,mate,black,504,C20,King's Pawn Game: Wayward Queen Attack
1370,1425,68,time,black,55,C20,King's Pawn Game: Wayward Queen Attack
1257,1296,84,mate,black,39,C20,King's Pawn Game: Wayward Queen Attack
1283,1255,68,mate,black,28,C20,King's Pawn Game: Wayward Queen Attack
1295,1226,82,mate,black,69,C20,King's Pawn Game: Wayward Queen Attack
1284,1370,34,mate,black,86,C20,King's Pawn Game: Wayward Queen Attack
1305,1360,40,resign,black,55,C20,King's Pawn Game: Wayward Queen Attack
1325,1361,128,mate,black,36,C20,King's Pawn Game: Wayward Queen Attack
1340,1316,40,mate,black,24,C20,King's Pawn Game: Wayward Queen Attack
1514,1524,44,mate,black,10,C20,King's Pawn Game: Wayward Queen Attack
1221,1226,106,mate,black,5,C20,King's Pawn Game: Wayward Queen Attack
1152,1152,32,mate,black,0,C20,King's Pawn Game: Wayward Queen Attack
1157,1092,120,mate,black,65,C20,King's Pawn Game: Wayward Queen Attack
1107,1631,16,resign,black,524,C20,King's Pawn Game: Wayward Queen Attack
1158,1766,22,resign,black,608,C20,King's Pawn Game: Wayward Queen Attack
989,1658,52,mate,black,669,C20,King's Pawn Game: Wayward Queen Attack
1003,1246,20,resign,black,243,C20,King's Pawn Game: Wayward Queen Attack
1092,1247,94,resign,black,155,C20,King's Pawn Game: Wayward Queen Attack
1121,1105,11,resign,black,16,C20,King's Pawn Game: Wayward Queen Attack
1558,1764,60,mate,black,206,C20,King's Pawn Game: Wayward Queen Attack
1005,1072,54,mate,black,67,C20,King's Pawn Game: Wayward Queen Attack
1026,916,56,mate,black,110,C20,King's Pawn Game: Wayward Queen Attack
1299,1371,86,time,black,72,C20,King's Pawn Game: Wayward Queen Attack
1338,1356,14,resign,black,18,C20,King's Pawn Game: Wayward Queen Attack
1147,1355,11,resign,black,208,C20,King's Pawn Game: Wayward Queen Attack
1337,1720,38,mate,black,383,C20,King's Pawn Game: Wayward Queen Attack
1351,1674,100,mate,black,323,C20,King's Pawn Game: Wayward Queen Attack
1362,1650,46,mate,black,288,C20,King's Pawn Game: Wayward Queen Attack
1378,1447,35,resign,black,69,C20,King's Pawn Game: Wayward Queen Attack
1332,1372,70,mate,black,40,C20,King's Pawn Game: Wayward Queen Attack
1591,1834,66,resign,black,243,C20,King's Pawn Game: Wayward Queen Attack
1397,1363,40,resign,black,34,C20,King's Pawn Game: Wayward Queen Attack
1397,1368,40,mate,black,29,C20,King's Pawn Game: Wayward Queen Attack
1446,1489,98,mate,black,43,C20,King's Pawn Game: Wayward Queen Attack
1344,1521,24,resign,black,177,C20,King's Pawn Game: Wayward Queen Attack |  Kiddie Countergambit
1347,1677,46,mate,black,330,C20,King's Pawn Game: Wayward Queen Attack |  Kiddie Countergambit
1485,1471,74,time,black,14,C20,King's Pawn Game: Wayward Queen Attack |  Kiddie Countergambit
1437,1475,56,mate,black,38,C20,King's Pawn Opening: 2.b3
1032,1140,10,resign,black,108,B20,King's Pawn Opening: Speers
1195,1123,86,mate,black,72,C40,Latvian Gambit
1270,1544,76,mate,black,274,B07,Lion Defense: Lion's Jaw
2064,1968,64,resign,black,96,A48,London System
2013,2188,72,resign,black,175,A48,London System
2035,2324,40,resign,black,289,A48,London System
2046,1950,48,resign,black,96,A48,London System
1525,1628,84,resign,black,103,A48,London System
1674,1655,50,mate,black,19,A50,Mexican Defense
1154,1676,40,resign,black,522,A00,Mieses Opening
1431,1355,26,mate,black,76,A00,Mieses Opening
1197,1078,78,resign,black,119,A00,Mieses Opening
1275,1504,128,mate,black,229,A00,Mieses Opening
1072,1625,60,mate,black,553,A00,Mieses Opening
1149,1677,34,resign,black,528,A00,Mieses Opening
1192,1487,78,resign,black,295,A00,Mieses Opening
1299,1376,42,mate,black,77,A00,Mieses Opening
1424,1708,26,mate,black,284,A00,Mieses Opening
1571,1554,106,mate,black,17,A00,Mieses Opening
1194,1299,50,mate,black,105,A00,Mieses Opening
1811,1854,52,resign,black,43,A00,Mieses Opening
1143,1718,64,mate,black,575,A00,Mieses Opening
1500,1742,18,mate,black,242,A00,Mieses Opening: Reversed Rat
1059,1224,14,resign,black,165,A00,Mieses Opening: Reversed Rat
1608,1511,100,mate,black,97,A00,Mieses Opening: Reversed Rat
1999,1929,62,resign,black,70,A00,Mieses Opening: Reversed Rat
1912,2003,44,resign,black,91,A00,Mieses Opening: Reversed Rat
1118,1002,112,mate,black,116,A40,Mikenas Defense
1236,1137,59,resign,black,99,A40,Mikenas Defense
1597,1500,37,resign,black,97,A40,Mikenas Defense
1734,1402,90,resign,black,332,A40,Mikenas Defense: Cannstatter Variation
1486,1909,40,resign,black,423,A40,Modern Defense
1678,1565,58,resign,black,113,B06,Modern Defense
1235,1592,60,resign,black,357,B06,Modern Defense
1235,1375,66,mate,black,140,B06,Modern Defense
1436,1568,78,resign,black,132,B06,Modern Defense
1155,1292,67,resign,black,137,A40,Modern Defense
1669,1792,126,resign,black,123,B06,Modern Defense
1331,2209,60,mate,black,878,A40,Modern Defense
1832,1873,82,mate,black,41,A40,Modern Defense
1841,1908,70,resign,black,67,A40,Modern Defense
1303,1307,56,mate,black,4,A40,Modern Defense
1365,1409,108,resign,black,44,A40,Modern Defense
1422,1173,64,mate,black,249,B06,Modern Defense
1588,1574,64,resign,black,14,A40,Modern Defense
1345,1701,58,mate,black,356,A40,Modern Defense
2046,2057,80,resign,black,11,A40,Modern Defense
1481,1464,70,time,black,17,B06,Modern Defense
1711,1759,80,mate,black,48,B06,Modern Defense
1829,1707,72,resign,black,122,A40,Modern Defense
1480,1533,58,resign,black,53,A40,Modern Defense
1479,1573,16,resign,black,94,A40,Modern Defense
1429,1432,48,resign,black,3,B06,Modern Defense
1240,1507,92,time,black,267,A40,Modern Defense
1248,1492,44,resign,black,244,B06,Modern Defense
1634,1526,44,resign,black,108,A40,Modern Defense
1137,1383,10,resign,black,246,A40,Modern Defense
1223,1333,40,resign,black,110,A40,Modern Defense
1353,1207,12,resign,black,146,B06,Modern Defense: Bishop Attack
1570,1611,34,resign,black,41,B06,Modern Defense: Geller's System
1639,1813,42,resign,black,174,B06,Modern Defense: Mongredien Defense #2
1404,1515,58,mate,black,111,B06,Modern Defense: Mongredien Defense #2
1953,1770,118,resign,black,183,B06,Modern Defense: Mongredien Defense #2
2175,2322,110,mate,black,147,B06,Modern Defense: Norwegian Defense
1984,1948,58,resign,black,36,B06,Modern Defense: Standard Defense
1426,1371,31,resign,black,55,B06,Modern Defense: Standard Line
1593,2216,76,time,black,623,B06,Modern Defense: Two Knights Variation
1385,1670,84,mate,black,285,B06,Modern Defense: Two Knights Variation |  Suttles Variation
2469,2369,96,time,black,100,B06,Modern Defense: Two Knights Variation |  Suttles Variation
1600,1387,162,mate,black,213,B06,Modern Defense: Two Knights Variation |  Suttles Variation
1818,1896,204,time,black,78,D70,Neo-Gruenfeld Defense
1335,1233,58,mate,black,102,E20,Nimzo-Indian Defense
2189,2167,54,resign,black,22,E20,Nimzo-Indian Defense
1212,2215,52,mate,black,1003,E20,Nimzo-Indian Defense
1453,1772,118,mate,black,319,E20,Nimzo-Indian Defense
1624,1629,68,mate,black,5,E20,Nimzo-Indian Defense
1688,1745,66,mate,black,57,E20,Nimzo-Indian Defense
1758,1745,68,resign,black,13,E20,Nimzo-Indian Defense
1741,1901,60,mate,black,160,E20,Nimzo-Indian Defense
1569,1775,40,resign,black,206,E20,Nimzo-Indian Defense
1664,1820,54,mate,black,156,E20,Nimzo-Indian Defense #2
1680,1048,18,mate,black,632,E20,Nimzo-Indian Defense #2
1654,1516,34,resign,black,138,E20,Nimzo-Indian Defense #2
1242,1216,56,mate,black,26,E50,Nimzo-Indian Defense: 4.e3 e8g8 |  5.Nf3 |  without ...d5
2088,2269,70,resign,black,181,E32,Nimzo-Indian Defense: Classical Variation
1850,2192,66,resign,black,342,E30,Nimzo-Indian Defense: Leningrad Variation
2249,2359,86,time,black,110,E53,Nimzo-Indian Defense: Normal Variation |  Gligoric System
1731,1978,48,resign,black,247,E56,Nimzo-Indian Defense: Normal Variation |  Gligoric System |  Bernstein Defense
1724,1958,50,resign,black,234,E56,Nimzo-Indian Defense: Normal Variation |  Gligoric System |  Bernstein Defense
1611,1945,72,time,black,334,E20,Nimzo-Indian Defense: Ragozin Variation
1973,2462,48,mate,black,489,E20,Nimzo-Indian Defense: Ragozin Variation
1582,1770,136,mate,black,188,E20,Nimzo-Indian Defense: Ragozin Variation
1174,1115,36,mate,black,59,E20,Nimzo-Indian Defense: Ragozin Variation
2270,1974,26,resign,black,296,E20,Nimzo-Indian Defense: Ragozin Variation
2218,1990,60,resign,black,228,E20,Nimzo-Indian Defense: Romanishin Variation #2
1871,1774,68,resign,black,97,E24,Nimzo-Indian Defense: Saemisch Variation |  Accelerated
1829,1843,64,mate,black,14,E24,Nimzo-Indian Defense: Saemisch Variation |  Accelerated
1279,1720,14,resign,black,441,A01,Nimzo-Larsen Attack
1279,1720,14,resign,black,441,A01,Nimzo-Larsen Attack
1148,1447,72,mate,black,299,A01,Nimzo-Larsen Attack
1189,1391,104,mate,black,202,A01,Nimzo-Larsen Attack
1974,1899,54,resign,black,75,A01,Nimzo-Larsen Attack: Classical Variation
1649,1510,74,resign,black,139,A01,Nimzo-Larsen Attack: Classical Variation
1526,1850,88,mate,black,324,A01,Nimzo-Larsen Attack: Classical Variation
1620,1709,38,mate,black,89,A01,Nimzo-Larsen Attack: Classical Variation
1636,1614,40,resign,black,22,A01,Nimzo-Larsen Attack: Classical Variation
1912,2316,39,resign,black,404,A01,Nimzo-Larsen Attack: Classical Variation
1615,1678,72,mate,black,63,A01,Nimzo-Larsen Attack: English Variation
1637,1821,54,mate,black,184,A01,Nimzo-Larsen Attack: Indian Variation
1050,1439,40,mate,black,389,A01,Nimzo-Larsen Attack: Indian Variation
884,951,26,time,black,67,A01,Nimzo-Larsen Attack: Modern Variation
1402,1208,10,mate,black,194,A01,Nimzo-Larsen Attack: Modern Variation
1775,1879,64,resign,black,104,A01,Nimzo-Larsen Attack: Modern Variation #2
1060,1134,108,mate,black,74,A01,Nimzo-Larsen Attack: Modern Variation #2
1606,1531,70,mate,black,75,A01,Nimzo-Larsen Attack: Modern Variation #2
1132,1193,97,resign,black,61,A01,Nimzo-Larsen Attack: Modern Variation #2
1467,1478,56,mate,black,11,A01,Nimzo-Larsen Attack: Modern Variation #3
1433,1481,56,mate,black,48,A01,Nimzo-Larsen Attack: Modern Variation #3
1104,1280,54,resign,black,176,A01,Nimzo-Larsen Attack: Modern Variation #3
1514,1694,74,mate,black,180,A01,Nimzo-Larsen Attack: Modern Variation #3
1655,1526,114,resign,black,129,A01,Nimzo-Larsen Attack: Modern Variation #3
1209,1291,56,resign,black,82,A01,Nimzo-Larsen Attack: Modern Variation #4
1936,1638,26,resign,black,298,A01,Nimzo-Larsen Attack: Modern Variation #4
1259,1494,35,resign,black,235,A01,Nimzo-Larsen Attack: Modern Variation #4
1635,1625,88,mate,black,10,A01,Nimzo-Larsen Attack: Modern Variation #4
1637,1408,50,mate,black,229,A01,Nimzo-Larsen Attack: Modern Variation #4
1801,1945,62,resign,black,144,A01,Nimzo-Larsen Attack: Modern Variation #4
1916,2285,44,resign,black,369,A01,Nimzo-Larsen Attack: Symmetrical Variation
2178,2187,66,resign,black,9,A01,Nimzo-Larsen Attack: Symmetrical Variation
1847,1762,96,time,black,85,B00,Nimzowitsch Defense
915,910,78,time,black,5,B00,Nimzowitsch Defense
1555,1607,45,resign,black,52,B00,Nimzowitsch Defense |  Declined Variation
1576,1500,56,resign,black,76,B00,Nimzowitsch Defense |  Declined Variation
1854,1814,110,resign,black,40,B00,Nimzowitsch Defense |  Declined Variation
1254,1256,74,resign,black,2,B00,Nimzowitsch Defense |  Declined Variation
2045,1750,62,resign,black,295,B00,Nimzowitsch Defense |  Declined Variation
1954,1850,196,mate,black,104,B00,Nimzowitsch Defense |  Declined Variation
1245,1294,100,resign,black,49,B00,Nimzowitsch Defense: Franco-Nimzowitsch Variation
1640,1849,36,mate,black,209,B00,Nimzowitsch Defense: Franco-Nimzowitsch Variation
1512,1548,50,resign,black,36,B00,Nimzowitsch Defense: Franco-Nimzowitsch Variation
1176,1526,60,mate,black,350,B00,Nimzowitsch Defense: French Connection
1322,1261,16,resign,black,61,B00,Nimzowitsch Defense: Kennedy Variation
1336,1412,38,resign,black,76,B00,Nimzowitsch Defense: Kennedy Variation
1359,1391,44,mate,black,32,B00,Nimzowitsch Defense: Kennedy Variation |  Keres Attack
1964,2287,88,resign,black,323,B00,Nimzowitsch Defense: Kennedy Variation |  Linksspringer Variation
1226,1198,58,mate,black,28,B00,Nimzowitsch Defense: Kennedy Variation |  Linksspringer Variation
1346,1361,25,resign,black,15,B00,Nimzowitsch Defense: Kennedy Variation |  Linksspringer Variation
1828,1801,62,resign,black,27,B00,Nimzowitsch Defense: Kennedy Variation |  Linksspringer Variation
1649,1445,121,resign,black,204,B00,Nimzowitsch Defense: Kennedy Variation |  Linksspringer Variation
1450,1649,80,mate,black,199,B00,Nimzowitsch Defense: Kennedy Variation |  Linksspringer Variation
1399,1638,60,resign,black,239,B00,Nimzowitsch Defense: Kennedy Variation |  Linksspringer Variation
1279,1363,27,resign,black,84,B00,Nimzowitsch Defense: Kennedy Variation |  Linksspringer Variation
1894,1938,39,resign,black,44,B00,Nimzowitsch Defense: Lean Variation |  Colorado Counter Accepted
1244,1219,26,time,black,25,B00,Nimzowitsch Defense: Mikenas Variation
1599,1545,98,resign,black,54,B00,Nimzowitsch Defense: Pseudo-Spanish Variation
1302,1278,52,time,black,24,B00,Nimzowitsch Defense: Pseudo-Spanish Variation
1585,1569,87,resign,black,16,B00,Nimzowitsch Defense: Scandinavian Variation |  Advance Variation
1304,1543,22,resign,black,239,B00,Nimzowitsch Defense: Scandinavian Variation |  Advance Variation
1565,1594,45,resign,black,29,B00,Nimzowitsch Defense: Scandinavian Variation |  Advance Variation
1157,1348,19,resign,black,191,B00,Nimzowitsch Defense: Scandinavian Variation |  Bogoljubov Variation
1418,1472,102,mate,black,54,B00,Nimzowitsch Defense: Williams Variation
1491,1425,54,resign,black,66,B00,Nimzowitsch Defense: Williams Variation
1519,1444,104,time,black,75,B00,Nimzowitsch Defense: Williams Variation
1640,1521,72,time,black,119,A06,Nimzowitsch-Larsen Attack
1648,1552,124,resign,black,96,A06,Nimzowitsch-Larsen Attack
1453,1796,58,mate,black,343,A06,Nimzowitsch-Larsen Attack
1841,2015,122,time,black,174,A43,Old Benoni Defense
1776,1821,120,mate,black,45,A43,Old Benoni Defense
1257,1715,36,resign,black,458,A43,Old Benoni Defense
1620,1986,126,time,black,366,A43,Old Benoni Defense
1523,1477,42,resign,black,46,A43,Old Benoni Defense
1531,1521,57,resign,black,10,A43,Old Benoni Defense
1540,1505,86,resign,black,35,A43,Old Benoni Defense
1478,1495,70,resign,black,17,A43,Old Benoni Defense
1716,1768,56,resign,black,52,A43,Old Benoni Defense #2
1205,1257,20,resign,black,52,A41,Old Indian Defense
1581,1535,62,mate,black,46,A41,Old Indian Defense
1550,1755,80,time,black,205,A41,Old Indian Defense
1477,1297,78,resign,black,180,A41,Old Indian Defense
1631,1593,52,time,black,38,A41,Old Indian Defense
1973,1856,68,resign,black,117,A41,Old Indian Defense
1650,1414,110,resign,black,236,A41,Old Indian Defense
1562,1715,95,resign,black,153,A54,Old Indian Defense: Tartakower-Indian
1577,1763,52,mate,black,186,A53,Old Indian: Czech Variation |  with Nc3
1432,1397,30,resign,black,35,A53,Old Indian: Czech Variation |  with Nc3
1197,1340,64,resign,black,143,B00,Owen Defense
1815,1889,30,resign,black,74,B00,Owen Defense
1680,1789,52,mate,black,109,B00,Owen Defense
1711,1760,78,resign,black,49,B00,Owen Defense
2313,2168,10,resign,black,145,B00,Owen Defense
1843,1938,48,resign,black,95,B00,Owen Defense
1852,1879,56,mate,black,27,B00,Owen Defense
1322,1836,48,resign,black,514,B00,Owen Defense
1138,1368,44,mate,black,230,B00,Owen Defense
1626,1708,95,resign,black,82,B00,Owen Defense
1587,1573,56,resign,black,14,B00,Owen Defense
1372,1461,12,resign,black,89,B00,Owen Defense
1819,1891,64,mate,black,72,B00,Owen Defense
1043,1701,63,resign,black,658,B00,Owen Defense
1873,1884,39,resign,black,11,B00,Owen Defense
1172,1137,108,mate,black,35,B00,Owen Defense
1500,1160,68,resign,black,340,B00,Owen Defense
1723,1642,60,resign,black,81,B00,Owen Defense
1963,1380,22,resign,black,583,B00,Owen Defense
1500,1519,80,mate,black,19,B00,Owen Defense
1717,1460,58,resign,black,257,B00,Owen Defense
1711,1456,128,resign,black,255,B00,Owen Defense
1385,1740,42,mate,black,355,B00,Owen Defense
1422,1706,32,resign,black,284,B00,Owen Defense
1489,1580,76,resign,black,91,B00,Owen Defense
1642,1847,71,resign,black,205,B00,Owen Defense
1854,1849,40,time,black,5,A45,Paleface Attack
1296,1120,72,mate,black,176,A45,Paleface Attack
1305,1455,46,resign,black,150,A45,Paleface Attack
1081,1416,26,mate,black,335,A45,Paleface Attack
1288,1454,104,resign,black,166,C42,Petrov's Defense
1176,1118,52,resign,black,58,C42,Petrov's Defense
1129,1096,52,resign,black,33,C42,Petrov's Defense
1445,1345,28,mate,black,100,C42,Petrov's Defense
1500,1458,32,resign,black,42,C42,Petrov's Defense
1274,982,25,resign,black,292,C42,Petrov's Defense
1623,1487,76,mate,black,136,C42,Petrov's Defense
1000,999,68,mate,black,1,C42,Petrov's Defense
1629,1659,56,resign,black,30,C42,Petrov's Defense #2
1895,1797,32,mate,black,98,C42,Petrov's Defense #2
1235,1246,21,resign,black,11,C42,Petrov's Defense #2
1575,1772,64,mate,black,197,C42,Petrov's Defense #2
1468,1489,68,resign,black,21,C43,Petrov: Modern Attack
1611,1839,58,resign,black,228,C43,Petrov: Modern Attack
1846,1869,69,resign,black,23,C41,Philidor Defense
1126,1054,56,mate,black,72,C41,Philidor Defense
1901,1993,132,resign,black,92,C41,Philidor Defense
1319,1633,30,time,black,314,C41,Philidor Defense
1536,1460,66,resign,black,76,C41,Philidor Defense
1935,1875,64,resign,black,60,C41,Philidor Defense
1482,1504,34,resign,black,22,C41,Philidor Defense
1333,1361,46,mate,black,28,C41,Philidor Defense
1513,1384,86,mate,black,129,C41,Philidor Defense
1156,1297,20,time,black,141,C41,Philidor Defense
1190,1337,62,resign,black,147,C41,Philidor Defense
1574,1678,112,resign,black,104,C41,Philidor Defense
1303,1284,122,resign,black,19,C41,Philidor Defense
1382,1388,40,resign,black,6,C41,Philidor Defense
1372,1434,172,time,black,62,C41,Philidor Defense
1993,1868,16,time,black,125,C41,Philidor Defense
1423,1432,68,resign,black,9,C41,Philidor Defense
1424,1441,49,resign,black,17,C41,Philidor Defense
1418,1574,77,resign,black,156,C41,Philidor Defense
1707,2021,56,time,black,314,C41,Philidor Defense
1699,1581,50,mate,black,118,C41,Philidor Defense
1257,1380,19,resign,black,123,C41,Philidor Defense #2
1278,1474,24,mate,black,196,C41,Philidor Defense #2
1577,1874,60,mate,black,297,C41,Philidor Defense #2
1438,1407,62,time,black,31,C41,Philidor Defense #2
1324,1599,30,resign,black,275,C41,Philidor Defense #2
1338,1200,70,mate,black,138,C41,Philidor Defense #2
1634,1715,64,resign,black,81,C41,Philidor Defense #2
1549,1720,44,resign,black,171,C41,Philidor Defense #2
1550,1511,122,resign,black,39,C41,Philidor Defense #2
1624,1504,86,resign,black,120,C41,Philidor Defense #2
1203,1140,26,resign,black,63,C41,Philidor Defense #2
1128,1347,20,resign,black,219,C41,Philidor Defense #2
1459,1392,64,resign,black,67,C41,Philidor Defense #2
1539,1632,108,resign,black,93,C41,Philidor Defense #2
1582,1590,92,resign,black,8,C41,Philidor Defense #2
1600,1571,210,mate,black,29,C41,Philidor Defense #2
1584,1543,120,mate,black,41,C41,Philidor Defense #2
1562,1554,116,mate,black,8,C41,Philidor Defense #2
1437,1370,126,resign,black,67,C41,Philidor Defense #2
1478,1319,46,resign,black,159,C41,Philidor Defense #2
1443,1337,44,resign,black,106,C41,Philidor Defense #2
1372,1398,64,resign,black,26,C41,Philidor Defense #2
1381,1377,94,resign,black,4,C41,Philidor Defense #2
1144,1601,22,resign,black,457,C41,Philidor Defense #2
1269,1162,42,mate,black,107,C41,Philidor Defense #2
1829,1812,142,mate,black,17,C41,Philidor Defense #2
1823,2012,150,mate,black,189,C41,Philidor Defense #2
1409,1468,83,resign,black,59,C41,Philidor Defense #2
1370,1327,86,resign,black,43,C41,Philidor Defense #2
1620,1838,118,mate,black,218,C41,Philidor Defense #2
1274,1570,60,mate,black,296,C41,Philidor Defense #2
1542,1213,72,resign,black,329,C41,Philidor Defense #2
1587,1423,44,mate,black,164,C41,Philidor Defense #2
1791,1851,58,mate,black,60,C41,Philidor Defense #2
1188,1415,102,resign,black,227,C41,Philidor Defense #2
1216,1523,34,resign,black,307,C41,Philidor Defense #2
1633,1581,98,resign,black,52,C41,Philidor Defense #3
1712,1875,66,resign,black,163,C41,Philidor Defense #3
1678,1017,17,resign,black,661,C41,Philidor Defense #3
1361,1370,52,resign,black,9,C41,Philidor Defense #3
1358,1315,10,time,black,43,C41,Philidor Defense #3
1412,1679,66,resign,black,267,C41,Philidor Defense #3
1525,1232,46,mate,black,293,C41,Philidor Defense #3
1491,1283,23,resign,black,208,C41,Philidor Defense #3
1351,1532,48,resign,black,181,C41,Philidor Defense #3
1970,1959,20,resign,black,11,C41,Philidor Defense #3
1955,1946,26,resign,black,9,C41,Philidor Defense #3
1023,1821,36,resign,black,798,C41,Philidor Defense #3
1162,1606,107,resign,black,444,C41,Philidor Defense #3
1331,1695,102,mate,black,364,C41,Philidor Defense #3
1560,1601,56,resign,black,41,C41,Philidor Defense #3
1101,1114,23,resign,black,13,C41,Philidor Defense #3
1277,1307,66,mate,black,30,C41,Philidor Defense #3
1538,1652,120,time,black,114,C41,Philidor Defense #3
1950,1876,146,resign,black,74,C41,Philidor Defense #3
1943,1882,58,resign,black,61,C41,Philidor Defense #3
1680,1673,76,resign,black,7,C41,Philidor Defense #3
1281,1765,112,mate,black,484,C41,Philidor Defense #4
1787,1749,54,resign,black,38,C41,Philidor Defense #4
1400,1712,18,resign,black,312,C41,Philidor Defense #4
1455,1679,34,mate,black,224,C41,Philidor Defense: Exchange Variation
1524,1518,43,resign,black,6,C41,Philidor Defense: Exchange Variation
1518,1603,74,time,black,85,C41,Philidor Defense: Exchange Variation
1985,1921,62,resign,black,64,C41,Philidor Defense: Exchange Variation
1688,1935,60,mate,black,247,C41,Philidor Defense: Exchange Variation
1263,1264,54,time,black,1,C41,Philidor Defense: Exchange Variation #2
1510,1452,48,resign,black,58,C41,Philidor Defense: Exchange Variation #2
1631,1826,82,mate,black,195,C41,Philidor Defense: Exchange Variation #2
1230,1334,72,mate,black,104,C41,Philidor Defense: Exchange Variation #3
1923,1887,40,resign,black,36,C41,Philidor Defense: Exchange Variation #3
1497,1426,40,resign,black,71,C41,Philidor Defense: Exchange Variation #3
1532,1583,108,mate,black,51,C41,Philidor Defense: Hanham Variation
1224,1294,52,resign,black,70,C41,Philidor Defense: Hanham Variation
1414,1442,30,resign,black,28,C41,Philidor Defense: Larsen Variation
1295,2112,28,resign,black,817,C41,Philidor Defense: Lion Variation
1730,1848,94,mate,black,118,C41,Philidor Defense: Lopez Countergambit
1255,1157,114,resign,black,98,C41,Philidor Defense: Nimzowitsch Variation
1117,898,44,mate,black,219,C41,Philidor Defense: Nimzowitsch Variation #2
1461,1567,51,resign,black,106,C41,Philidor Defense: Nimzowitsch Variation #2
1651,1650,70,resign,black,1,C41,Philidor Defense: Nimzowitsch Variation |  Klein Variation
1094,1334,58,mate,black,240,C41,Philidor Defense: Philidor Countergambit
1648,1591,40,resign,black,57,B07,Pirc Defense
810,1218,20,time,black,408,B07,Pirc Defense
2104,2340,60,resign,black,236,B07,Pirc Defense
1687,1668,37,resign,black,19,B07,Pirc Defense #2
1746,1739,50,time,black,7,B07,Pirc Defense #2
1492,1560,100,resign,black,68,B07,Pirc Defense #4
1321,1259,16,resign,black,62,B07,Pirc Defense #4
1696,1659,38,mate,black,37,B07,Pirc Defense #4
1300,1749,84,resign,black,449,B07,Pirc Defense #4
1589,1444,45,resign,black,145,B07,Pirc Defense #4
2513,2383,150,resign,black,130,B07,Pirc Defense #4
1565,1659,50,resign,black,94,B07,Pirc Defense #4
1746,1479,52,resign,black,267,B07,Pirc Defense #4
1444,1475,33,resign,black,31,B07,Pirc Defense #4
1390,1413,50,resign,black,23,B07,Pirc Defense #4
1387,1401,105,resign,black,14,B07,Pirc Defense #4
1500,1500,48,resign,black,0,B07,Pirc Defense #4
1364,1356,122,mate,black,8,B07,Pirc Defense #5
1561,1574,34,resign,black,13,B07,Pirc Defense #5
1641,1619,100,time,black,22,B07,Pirc Defense #5
1630,1420,84,time,black,210,B07,Pirc Defense #5
1500,1432,52,mate,black,68,B07,Pirc Defense #5
1624,1864,37,resign,black,240,B07,Pirc Defense #5
1623,1701,30,resign,black,78,B07,Pirc Defense: Byrne Variation
1657,1614,42,resign,black,43,B07,Pirc Defense: Byrne Variation
1446,1436,104,resign,black,10,B07,Pirc Defense: Byrne Variation
1657,1678,54,resign,black,21,B08,Pirc Defense: Classical Variation
1695,1691,112,resign,black,4,B08,Pirc Defense: Classical Variation
1728,1853,42,mate,black,125,B08,Pirc Defense: Classical Variation
978,1179,62,mate,black,201,B08,Pirc Defense: Classical Variation
1950,2049,38,resign,black,99,B08,Pirc Defense: Classical Variation
1402,1642,18,time,black,240,B08,Pirc Defense: Classical Variation
1480,1551,58,resign,black,71,B07,Pirc Defense: Kholmov System
1178,1616,58,mate,black,438,B07,Pirc Defense: Kholmov System
1677,1627,124,resign,black,50,A00,Polish Opening
1102,1685,48,resign,black,583,A00,Polish Opening
1500,1482,52,mate,black,18,A00,Polish Opening
1032,1011,44,mate,black,21,A00,Polish Opening
1822,1798,105,resign,black,24,A00,Polish Opening
1006,1679,20,mate,black,673,A00,Polish Opening
1203,1422,36,mate,black,219,A00,Polish Opening
1703,1703,78,resign,black,0,A00,Polish Opening
1822,2192,86,time,black,370,A00,Polish Opening
1246,1441,33,resign,black,195,A00,Polish Opening
1838,2026,40,resign,black,188,A00,Polish Opening
1707,1775,62,resign,black,68,A00,Polish Opening: King's Indian Variation
1820,1842,38,mate,black,22,A00,Polish Opening: Schiffler-Sokolsky Variation
1567,1456,110,mate,black,111,C44,Ponziani Opening
1401,1346,41,resign,black,55,C44,Ponziani Opening
1465,1432,102,mate,black,33,C44,Ponziani Opening
1020,1618,90,resign,black,598,C44,Ponziani Opening
1340,1511,67,resign,black,171,C44,Ponziani Opening: Jaenisch Counterattack
949,1416,56,mate,black,467,C44,Ponziani Opening: Jaenisch Counterattack
1449,1463,42,resign,black,14,C44,Ponziani Opening: Jaenisch Counterattack
1587,1568,65,resign,black,19,C44,Ponziani Opening: Jaenisch Counterattack
1198,1316,78,mate,black,118,C44,Ponziani Opening: Jaenisch Counterattack
998,1016,8,time,black,18,C44,Ponziani Opening: Romanishin Variation
1798,1764,32,resign,black,34,C44,Ponziani Opening: Spanish Variation
1405,1365,48,resign,black,40,C20,Portuguese Opening
1244,1394,24,mate,black,150,C20,Portuguese Opening
1584,1371,26,resign,black,213,C20,Portuguese Opening
1500,1769,42,time,black,269,C20,Portuguese Opening
1147,1087,30,mate,black,60,C20,Portuguese Opening
1392,1501,56,mate,black,109,C20,Portuguese Opening: Portuguese Gambit
1278,1357,42,mate,black,79,D06,Queen's Gambit
1456,1604,52,mate,black,148,D20,Queen's Gambit Accepted
1324,1878,97,resign,black,554,D20,Queen's Gambit Accepted
1156,1442,60,resign,black,286,D20,Queen's Gambit Accepted
1147,1158,17,resign,black,11,D20,Queen's Gambit Accepted
1279,1528,96,mate,black,249,D20,Queen's Gambit Accepted
1445,1428,58,mate,black,17,D20,Queen's Gambit Accepted
1994,2048,69,resign,black,54,D20,Queen's Gambit Accepted
1746,1645,32,resign,black,101,D20,Queen's Gambit Accepted
1771,1588,89,resign,black,183,D20,Queen's Gambit Accepted
1282,1213,44,resign,black,69,D20,Queen's Gambit Accepted
1305,1479,45,resign,black,174,D20,Queen's Gambit Accepted
1199,1002,112,mate,black,197,D20,Queen's Gambit Accepted: Accelerated Mannheim Variation
1632,1232,68,mate,black,400,D20,Queen's Gambit Accepted: Accelerated Mannheim Variation
1291,1500,41,resign,black,209,D20,Queen's Gambit Accepted: Accelerated Mannheim Variation
1550,1620,52,resign,black,70,D24,Queen's Gambit Accepted: Bogoljubov Defense
1424,1356,40,mate,black,68,D20,Queen's Gambit Accepted: Central Variation |  Greco Variation
1616,1600,21,resign,black,16,D20,Queen's Gambit Accepted: Central Variation |  Greco Variation
1819,1889,170,resign,black,70,D20,Queen's Gambit Accepted: Central Variation |  Rubinstein Defense |  Yefimov Gambit
1426,1159,18,resign,black,267,D21,Queen's Gambit Accepted: Gunsberg Defense
1935,1867,160,time,black,68,D25,Queen's Gambit Accepted: Normal Variation
1769,1396,28,resign,black,373,D20,Queen's Gambit Accepted: Old Variation
1245,1346,38,resign,black,101,D20,Queen's Gambit Accepted: Old Variation
1314,1270,32,resign,black,44,D20,Queen's Gambit Accepted: Old Variation
1318,1366,56,resign,black,48,D20,Queen's Gambit Accepted: Old Variation
1345,1187,40,mate,black,158,D20,Queen's Gambit Accepted: Old Variation
1551,1842,70,resign,black,291,D20,Queen's Gambit Accepted: Old Variation
1196,1348,20,resign,black,152,D20,Queen's Gambit Accepted: Old Variation
1579,1664,66,time,black,85,D20,Queen's Gambit Accepted: Old Variation
1531,1689,118,resign,black,158,D20,Queen's Gambit Accepted: Old Variation
1690,1540,134,resign,black,150,D20,Queen's Gambit Accepted: Old Variation
1507,1573,56,mate,black,66,D20,Queen's Gambit Accepted: Old Variation
1801,1686,42,resign,black,115,D20,Queen's Gambit Accepted: Old Variation
1764,1711,52,mate,black,53,D20,Queen's Gambit Accepted: Old Variation
1862,1823,44,resign,black,39,D20,Queen's Gambit Accepted: Old Variation
1691,1682,43,resign,black,9,D20,Queen's Gambit Accepted: Old Variation
1827,1829,52,resign,black,2,D20,Queen's Gambit Accepted: Old Variation
1687,1732,54,resign,black,45,D20,Queen's Gambit Accepted: Old Variation
2114,2042,74,resign,black,72,D21,Queen's Gambit Accepted: Rosenthal Variation
1862,1358,34,resign,black,504,D20,Queen's Gambit Accepted: Saduleto Variation
1884,1827,94,mate,black,57,D24,Queen's Gambit Accepted: Showalter Variation
1228,1626,18,resign,black,398,D30,Queen's Gambit Declined
1511,1516,54,resign,black,5,D30,Queen's Gambit Declined
1380,2239,78,resign,black,859,D30,Queen's Gambit Declined
1647,1566,62,resign,black,81,D30,Queen's Gambit Declined
1534,1581,48,resign,black,47,D30,Queen's Gambit Declined
1259,1184,48,resign,black,75,D30,Queen's Gambit Declined
1288,1138,32,resign,black,150,D30,Queen's Gambit Declined
2018,2167,87,resign,black,149,D30,Queen's Gambit Declined
1692,2143,48,resign,black,451,D30,Queen's Gambit Declined
1602,1636,52,resign,black,34,D30,Queen's Gambit Declined
1279,1629,60,mate,black,350,D30,Queen's Gambit Declined
1231,1205,34,resign,black,26,D30,Queen's Gambit Declined
1570,1414,16,mate,black,156,D30,Queen's Gambit Declined
2250,2091,82,time,black,159,D30,Queen's Gambit Declined
1673,1717,72,mate,black,44,D30,Queen's Gambit Declined
2144,2001,78,resign,black,143,D30,Queen's Gambit Declined
1806,1786,41,resign,black,20,D30,Queen's Gambit Declined
2075,2303,102,mate,black,228,D30,Queen's Gambit Declined
1616,1802,50,mate,black,186,D30,Queen's Gambit Declined
1292,1947,23,resign,black,655,D30,Queen's Gambit Declined
1468,1553,24,resign,black,85,D30,Queen's Gambit Declined
1325,1617,104,resign,black,292,D30,Queen's Gambit Declined
1803,1859,82,mate,black,56,D30,Queen's Gambit Declined
1530,1843,26,resign,black,313,D30,Queen's Gambit Declined
1654,1918,76,resign,black,264,D53,Queen's Gambit Declined: 4.Bg5 Be7
1701,1816,36,resign,black,115,D55,Queen's Gambit Declined: Anti-Tartakower Variation
1298,1285,30,resign,black,13,D35,Queen's Gambit Declined: Exchange Variation
1862,1846,72,resign,black,16,D35,Queen's Gambit Declined: Exchange Variation |  Positional Variation
1300,1330,84,resign,black,30,D35,Queen's Gambit Declined: Exchange Variation |  Positional Variation #2
1883,1877,64,resign,black,6,D35,Queen's Gambit Declined: Exchange Variation |  Positional Variation #2
1803,1778,121,resign,black,25,D37,Queen's Gambit Declined: Harrwitz Attack
1712,1973,124,resign,black,261,D37,Queen's Gambit Declined: Harrwitz Attack |  Orthodox Defense
1845,2011,76,mate,black,166,D56,Queen's Gambit Declined: Lasker Defense
1321,1451,90,resign,black,130,D50,Queen's Gambit Declined: Modern Variation
1437,1458,15,resign,black,21,D50,Queen's Gambit Declined: Modern Variation
1493,1488,76,mate,black,5,D50,Queen's Gambit Declined: Modern Variation
1836,1987,108,resign,black,151,D55,Queen's Gambit Declined: Modern Variation |  Normal Line
1839,1967,64,time,black,128,D55,Queen's Gambit Declined: Modern Variation |  Normal Line
1903,1744,82,resign,black,159,D55,Queen's Gambit Declined: Modern Variation |  Normal Line
1722,1817,160,mate,black,95,D51,Queen's Gambit Declined: Modern |  Knight Defense #3
1853,1595,76,resign,black,258,D35,Queen's Gambit Declined: Normal Defense
1256,1703,32,resign,black,447,D35,Queen's Gambit Declined: Normal Defense
2080,2157,56,resign,black,77,D35,Queen's Gambit Declined: Normal Defense
1998,1963,58,mate,black,35,D35,Queen's Gambit Declined: Normal Defense
1567,1520,40,resign,black,47,D35,Queen's Gambit Declined: Normal Defense
1989,2016,36,resign,black,27,D35,Queen's Gambit Declined: Normal Defense
1334,1572,60,resign,black,238,D35,Queen's Gambit Declined: Normal Defense
1270,1247,60,resign,black,23,D35,Queen's Gambit Declined: Normal Defense
1352,1149,52,resign,black,203,D31,Queen's Gambit Declined: Queen's Knight Variation
1887,1892,48,resign,black,5,D31,Queen's Gambit Declined: Queen's Knight Variation
1795,1578,68,resign,black,217,D31,Queen's Gambit Declined: Queen's Knight Variation
1463,1413,40,mate,black,50,D31,Queen's Gambit Declined: Queen's Knight Variation
1237,1615,82,mate,black,378,D31,Queen's Gambit Declined: Queen's Knight Variation
1810,1575,84,resign,black,235,D40,Queen's Gambit Declined: Semi-Tarrasch Defense |  Pillsbury Variation
1749,1631,18,resign,black,118,D41,Queen's Gambit Declined: Semi-Tarrasch |  5.cxd5
1923,1211,74,resign,black,712,D41,Queen's Gambit Declined: Semi-Tarrasch |  5.cxd5
1454,1421,54,resign,black,33,D30,Queen's Gambit Declined: Tarrasch Defense |  Pseudo-Tarrasch
1555,1569,102,mate,black,14,D30,Queen's Gambit Declined: Tarrasch Defense |  Pseudo-Tarrasch
1824,1798,44,resign,black,26,D30,Queen's Gambit Declined: Tarrasch Defense |  Pseudo-Tarrasch
1746,1729,80,mate,black,17,D30,Queen's Gambit Declined: Tarrasch Defense |  Pseudo-Tarrasch
1957,2174,54,resign,black,217,D37,Queen's Gambit Declined: Three Knights Variation
1557,1849,118,mate,black,292,D37,Queen's Gambit Declined: Three Knights Variation
1750,1684,49,resign,black,66,D37,Queen's Gambit Declined: Three Knights Variation
1616,1588,56,resign,black,28,D37,Queen's Gambit Declined: Three Knights Variation
1562,1651,90,resign,black,89,D37,Queen's Gambit Declined: Three Knights Variation
1331,1382,52,resign,black,51,D08,Queen's Gambit Refused: Albin Countergambit
1927,1797,37,resign,black,130,D08,Queen's Gambit Refused: Albin Countergambit
1852,1855,102,resign,black,3,D08,Queen's Gambit Refused: Albin Countergambit
1543,1456,50,time,black,87,D08,Queen's Gambit Refused: Albin Countergambit
1804,1752,152,mate,black,52,D08,Queen's Gambit Refused: Albin Countergambit
1748,1764,40,mate,black,16,D08,Queen's Gambit Refused: Albin Countergambit |  Normal Line
1621,1403,34,resign,black,218,D06,Queen's Gambit Refused: Austrian Attack |  Salvio Countergambit
1528,1519,84,resign,black,9,D06,Queen's Gambit Refused: Austrian Defense
1281,1568,34,mate,black,287,D06,Queen's Gambit Refused: Austrian Defense
1448,1436,32,resign,black,12,D02,Queen's Gambit Refused: Baltic Defense
1564,1598,12,resign,black,34,D02,Queen's Gambit Refused: Baltic Defense
2037,2157,62,mate,black,120,D02,Queen's Gambit Refused: Baltic Defense |  Pseudo-Chigorin
2093,1932,12,resign,black,161,D02,Queen's Gambit Refused: Baltic Defense |  Pseudo-Slav
1560,1270,40,mate,black,290,D07,Queen's Gambit Refused: Chigorin Defense #2
1159,1019,68,mate,black,140,D07,Queen's Gambit Refused: Chigorin Defense #3
1627,1508,52,resign,black,119,D07,Queen's Gambit Refused: Chigorin Defense #3
1570,1705,14,resign,black,135,D07,Queen's Gambit Refused: Chigorin Defense #3
1715,1343,80,mate,black,372,D07,Queen's Gambit Refused: Chigorin Defense |  Exchange Variation
1329,1282,102,resign,black,47,D07,Queen's Gambit Refused: Chigorin Defense |  Janowski Variation
1551,1479,76,time,black,72,D06,Queen's Gambit Refused: Chigorin Defense |  Lazard Gambit
1257,1325,72,resign,black,68,D06,Queen's Gambit Refused: Chigorin Defense |  Modern Gambit
1449,1416,54,resign,black,33,D06,Queen's Gambit Refused: Chigorin Defense |  Modern Gambit
1077,1148,66,mate,black,71,D06,Queen's Gambit Refused: Marshall Defense
1132,1276,24,resign,black,144,D06,Queen's Gambit Refused: Marshall Defense
1394,1512,50,mate,black,118,D06,Queen's Gambit Refused: Marshall Defense
1656,1729,80,resign,black,73,D06,Queen's Gambit Refused: Marshall Defense
1453,1412,46,mate,black,41,D06,Queen's Gambit Refused: Marshall Defense
2169,2221,67,resign,black,52,D06,Queen's Gambit Refused: Marshall Defense
1989,2160,84,mate,black,171,D06,Queen's Gambit Refused: Marshall Defense
1693,1455,96,mate,black,238,D06,Queen's Gambit Refused: Marshall Defense
1669,1502,70,mate,black,167,D06,Queen's Gambit Refused: Marshall Defense
1593,1474,30,resign,black,119,D06,Queen's Gambit Refused: Marshall Defense
1514,1512,46,resign,black,2,D06,Queen's Gambit Refused: Marshall Defense
1631,1665,52,resign,black,34,D06,Queen's Gambit Refused: Marshall Defense
1600,1595,58,resign,black,5,D06,Queen's Gambit Refused: Marshall Defense
1134,1535,62,mate,black,401,A47,Queen's Indian Defense
2204,2157,62,time,black,47,E16,Queen's Indian Defense: Capablanca Variation
1906,1834,60,resign,black,72,E17,Queen's Indian Defense: Classical Variation
1951,2109,82,resign,black,158,E17,Queen's Indian Defense: Classical Variation
1803,2215,65,resign,black,412,E14,Queen's Indian Defense: Spassky System
1823,1868,50,mate,black,45,E14,Queen's Indian Defense: Spassky System
1579,1470,62,mate,black,109,A41,Queen's Pawn
1048,1077,128,mate,black,29,A40,Queen's Pawn
1243,1378,122,mate,black,135,A41,Queen's Pawn
1533,1507,120,mate,black,26,A40,Queen's Pawn
1436,1434,68,mate,black,2,A40,Queen's Pawn
1696,1629,76,time,black,67,A41,Queen's Pawn
1472,1691,46,resign,black,219,A41,Queen's Pawn
1840,1606,88,resign,black,234,A41,Queen's Pawn
1879,1844,96,resign,black,35,A41,Queen's Pawn
2081,2082,130,resign,black,1,A40,Queen's Pawn
1313,1330,90,time,black,17,A40,Queen's Pawn
1570,1538,80,mate,black,32,A41,Queen's Pawn
1450,1392,62,mate,black,58,A40,Queen's Pawn
1776,1587,48,mate,black,189,D00,Queen's Pawn Game
1646,1795,2,time,black,149,D00,Queen's Pawn Game
1273,1160,22,resign,black,113,D00,Queen's Pawn Game
2083,2415,28,resign,black,332,D00,Queen's Pawn Game
1026,1121,4,resign,black,95,D00,Queen's Pawn Game
1222,1351,58,resign,black,129,D00,Queen's Pawn Game
1500,1409,36,mate,black,91,D00,Queen's Pawn Game
1261,1397,110,mate,black,136,D00,Queen's Pawn Game
1340,1433,104,resign,black,93,D00,Queen's Pawn Game
1850,1871,66,resign,black,21,D00,Queen's Pawn Game
1487,1562,46,mate,black,75,D00,Queen's Pawn Game
1201,1871,56,resign,black,670,D00,Queen's Pawn Game
1453,1222,98,resign,black,231,D00,Queen's Pawn Game
1152,1218,38,resign,black,66,D00,Queen's Pawn Game
1805,1757,34,resign,black,48,D00,Queen's Pawn Game
1052,1304,2,resign,black,252,D00,Queen's Pawn Game
1626,1353,42,mate,black,273,D00,Queen's Pawn Game
1392,1183,2,time,black,209,D00,Queen's Pawn Game
1405,1420,34,resign,black,15,D00,Queen's Pawn Game
1387,1783,70,mate,black,396,D00,Queen's Pawn Game
1266,1556,56,resign,black,290,D00,Queen's Pawn Game
1365,1653,33,resign,black,288,D00,Queen's Pawn Game
1477,2047,52,mate,black,570,D00,Queen's Pawn Game
1281,1342,22,resign,black,61,D00,Queen's Pawn Game
1540,2266,122,mate,black,726,D00,Queen's Pawn Game
1251,1354,26,resign,black,103,D00,Queen's Pawn Game
1514,1578,72,mate,black,64,D00,Queen's Pawn Game
1345,1363,54,mate,black,18,D00,Queen's Pawn Game
1629,1887,64,resign,black,258,D00,Queen's Pawn Game #2
1142,1679,64,resign,black,537,D00,Queen's Pawn Game #2
1417,1447,122,resign,black,30,D00,Queen's Pawn Game #2
1433,1737,118,time,black,304,D00,Queen's Pawn Game #2
1136,1301,44,resign,black,165,D00,Queen's Pawn Game #2
1384,1393,68,resign,black,9,D00,Queen's Pawn Game #2
1043,1539,64,mate,black,496,D00,Queen's Pawn Game #2
1349,1449,122,mate,black,100,D00,Queen's Pawn Game #2
1299,1583,48,time,black,284,D00,Queen's Pawn Game #2
1695,1789,79,resign,black,94,D00,Queen's Pawn Game #2
1327,1388,144,time,black,61,D00,Queen's Pawn Game #2
1351,1459,90,mate,black,108,D00,Queen's Pawn Game #2
1384,1658,82,resign,black,274,D00,Queen's Pawn Game #2
1380,1654,51,resign,black,274,D00,Queen's Pawn Game #2
1340,1366,60,mate,black,26,D00,Queen's Pawn Game #2
1500,1258,58,mate,black,242,D00,Queen's Pawn Game #2
1104,1430,50,mate,black,326,D00,Queen's Pawn Game #2
1257,1343,60,mate,black,86,D00,Queen's Pawn Game #2
1595,1483,66,mate,black,112,D00,Queen's Pawn Game #2
1617,2028,20,mate,black,411,D00,Queen's Pawn Game #2
1291,1320,28,resign,black,29,D00,Queen's Pawn Game #2
1589,1604,66,resign,black,15,D00,Queen's Pawn Game #2
1062,923,55,resign,black,139,D00,Queen's Pawn Game #2
1727,1877,56,resign,black,150,D00,Queen's Pawn Game #3
1276,1573,52,mate,black,297,D00,Queen's Pawn Game #3
1026,1864,84,mate,black,838,D00,Queen's Pawn Game #3
1873,2105,48,resign,black,232,D00,Queen's Pawn Game #3
1683,1901,42,resign,black,218,D00,Queen's Pawn Game #3
909,1227,38,resign,black,318,D00,Queen's Pawn Game #3
1654,1561,104,resign,black,93,D00,Queen's Pawn Game #3
1437,1786,34,resign,black,349,D00,Queen's Pawn Game #3
1077,1631,56,mate,black,554,D00,Queen's Pawn Game #3
1640,1567,38,mate,black,73,D00,Queen's Pawn Game #3
1829,1500,164,resign,black,329,D00,Queen's Pawn Game #3
1135,1366,54,resign,black,231,D02,Queen's Pawn Game: Anti-Torre
1547,1317,64,mate,black,230,D02,Queen's Pawn Game: Anti-Torre
1409,1439,36,mate,black,30,D02,Queen's Pawn Game: Anti-Torre
1411,1916,92,resign,black,505,D02,Queen's Pawn Game: Anti-Torre
1328,1038,54,mate,black,290,D01,Queen's Pawn Game: Chigorin Variation
974,1129,37,resign,black,155,D00,Queen's Pawn Game: Chigorin Variation
1047,1151,42,mate,black,104,D02,Queen's Pawn Game: Chigorin Variation
1115,1223,44,resign,black,108,D01,Queen's Pawn Game: Chigorin Variation
1190,1213,20,resign,black,23,D01,Queen's Pawn Game: Chigorin Variation
1270,1299,58,resign,black,29,D00,Queen's Pawn Game: Chigorin Variation
1034,1149,12,resign,black,115,D01,Queen's Pawn Game: Chigorin Variation
1131,1347,58,mate,black,216,D01,Queen's Pawn Game: Chigorin Variation
1648,1710,66,resign,black,62,D02,Queen's Pawn Game: Chigorin Variation
1750,1885,78,resign,black,135,D01,Queen's Pawn Game: Chigorin Variation
1175,1270,52,mate,black,95,D01,Queen's Pawn Game: Chigorin Variation
1342,1248,84,resign,black,94,D01,Queen's Pawn Game: Chigorin Variation
1176,1658,60,mate,black,482,D01,Queen's Pawn Game: Chigorin Variation
1099,1279,62,mate,black,180,D00,Queen's Pawn Game: Chigorin Variation
1258,1481,23,resign,black,223,D02,Queen's Pawn Game: Chigorin Variation
1500,1501,98,resign,black,1,D02,Queen's Pawn Game: Chigorin Variation
1507,1757,34,resign,black,250,D02,Queen's Pawn Game: Chigorin Variation
1589,1386,18,resign,black,203,D02,Queen's Pawn Game: Chigorin Variation
1296,1051,47,resign,black,245,D02,Queen's Pawn Game: Chigorin Variation
1666,1212,96,resign,black,454,D01,Queen's Pawn Game: Chigorin Variation
1691,1696,88,resign,black,5,D02,Queen's Pawn Game: Chigorin Variation
1453,1261,30,mate,black,192,D00,Queen's Pawn Game: Chigorin Variation
1369,2070,88,time,black,701,D01,Queen's Pawn Game: Chigorin Variation
1368,1496,29,resign,black,128,D01,Queen's Pawn Game: Chigorin Variation
1718,1587,84,time,black,131,D02,Queen's Pawn Game: Chigorin Variation
1572,1484,90,resign,black,88,D02,Queen's Pawn Game: Chigorin Variation
1478,1503,52,mate,black,25,D02,Queen's Pawn Game: Chigorin Variation
1810,1817,62,mate,black,7,D02,Queen's Pawn Game: Chigorin Variation
1932,2075,48,resign,black,143,D01,Queen's Pawn Game: Chigorin Variation
1521,1892,112,mate,black,371,D00,Queen's Pawn Game: Chigorin Variation
1716,1684,52,mate,black,32,D01,Queen's Pawn Game: Chigorin Variation
1423,1533,52,resign,black,110,D02,Queen's Pawn Game: Chigorin Variation
1406,1655,10,resign,black,249,D01,Queen's Pawn Game: Chigorin Variation
2106,2031,84,time,black,75,D01,Queen's Pawn Game: Chigorin Variation
1248,1568,10,resign,black,320,D01,Queen's Pawn Game: Chigorin Variation
1748,1853,40,resign,black,105,D01,Queen's Pawn Game: Chigorin Variation
1636,1784,40,mate,black,148,D02,Queen's Pawn Game: Chigorin Variation
1268,1341,26,resign,black,73,D02,Queen's Pawn Game: Chigorin Variation
1423,1584,60,mate,black,161,D02,Queen's Pawn Game: Chigorin Variation
1015,1301,132,mate,black,286,D00,Queen's Pawn Game: Chigorin Variation
2055,2155,88,resign,black,100,D02,Queen's Pawn Game: Chigorin Variation
1232,1761,40,resign,black,529,D01,Queen's Pawn Game: Chigorin Variation
1487,2097,26,resign,black,610,D01,Queen's Pawn Game: Chigorin Variation
1635,1593,112,time,black,42,D00,Queen's Pawn Game: Chigorin Variation
1606,1571,44,time,black,35,D02,Queen's Pawn Game: Chigorin Variation
1252,1714,34,mate,black,462,D00,Queen's Pawn Game: Chigorin Variation
1300,1912,24,resign,black,612,D01,Queen's Pawn Game: Chigorin Variation
1728,1933,109,resign,black,205,D01,Queen's Pawn Game: Chigorin Variation
1513,1802,150,time,black,289,D00,Queen's Pawn Game: Chigorin Variation
1555,2197,76,mate,black,642,D01,Queen's Pawn Game: Chigorin Variation
1159,911,54,resign,black,248,D00,Queen's Pawn Game: Chigorin Variation
1642,1273,88,time,black,369,D00,Queen's Pawn Game: Chigorin Variation
1529,1534,100,mate,black,5,D04,Queen's Pawn Game: Colle System
1193,1298,110,resign,black,105,D04,Queen's Pawn Game: Colle System
1808,1947,45,resign,black,139,D04,Queen's Pawn Game: Colle System
1435,2042,52,time,black,607,D04,Queen's Pawn Game: Colle System
1502,1368,68,mate,black,134,D04,Queen's Pawn Game: Colle System
1292,1358,46,mate,black,66,D04,Queen's Pawn Game: Colle System
1334,1384,64,mate,black,50,D04,Queen's Pawn Game: Colle System
1344,1221,6,resign,black,123,D04,Queen's Pawn Game: Colle System
1286,1318,32,resign,black,32,D04,Queen's Pawn Game: Colle System
1418,2203,48,mate,black,785,D04,Queen's Pawn Game: Colle System
1189,1298,26,resign,black,109,D04,Queen's Pawn Game: Colle System
1519,1536,28,resign,black,17,D04,Queen's Pawn Game: Colle System
1705,1676,60,resign,black,29,D04,Queen's Pawn Game: Colle System
1370,1372,44,resign,black,2,D04,Queen's Pawn Game: Colle System
1977,1919,56,resign,black,58,D04,Queen's Pawn Game: Colle System |  Anti-Colle
1211,2025,96,mate,black,814,D04,Queen's Pawn Game: Colle System |  Anti-Colle
1217,1041,130,mate,black,176,D04,Queen's Pawn Game: Colle System |  Anti-Colle
1629,1603,70,resign,black,26,C00,Queen's Pawn Game: Franco-Sicilian Defense
1445,1497,53,resign,black,52,C00,Queen's Pawn Game: Franco-Sicilian Defense
1556,1588,52,resign,black,32,C00,Queen's Pawn Game: Franco-Sicilian Defense
1221,1334,36,resign,black,113,C00,Queen's Pawn Game: Franco-Sicilian Defense
1455,1568,62,mate,black,113,D02,Queen's Pawn Game: Krause Variation
1620,1581,64,resign,black,39,D02,Queen's Pawn Game: Krause Variation
1629,1476,83,resign,black,153,D02,Queen's Pawn Game: Krause Variation
1522,1523,42,resign,black,1,D02,Queen's Pawn Game: Krause Variation
1834,1848,98,mate,black,14,D00,Queen's Pawn Game: Levitsky Attack
1843,1818,168,mate,black,25,D00,Queen's Pawn Game: Levitsky Attack
1760,1683,70,mate,black,77,D00,Queen's Pawn Game: Levitsky Attack
1210,2026,38,mate,black,816,D00,Queen's Pawn Game: Levitsky Attack
1579,2105,47,resign,black,526,D02,Queen's Pawn Game: London System
1543,1593,20,resign,black,50,D02,Queen's Pawn Game: London System
1546,1877,62,resign,black,331,D02,Queen's Pawn Game: London System
1783,1721,90,resign,black,62,D02,Queen's Pawn Game: London System
1614,1238,60,mate,black,376,D02,Queen's Pawn Game: London System
1353,1068,50,mate,black,285,D02,Queen's Pawn Game: London System
1476,1474,82,mate,black,2,D02,Queen's Pawn Game: London System
1262,1661,38,resign,black,399,D02,Queen's Pawn Game: London System
2035,1629,60,mate,black,406,D02,Queen's Pawn Game: London System
2190,2234,178,mate,black,44,D02,Queen's Pawn Game: London System
2226,2219,56,time,black,7,D02,Queen's Pawn Game: London System
2221,2209,116,resign,black,12,D02,Queen's Pawn Game: London System
2230,2201,74,mate,black,29,D02,Queen's Pawn Game: London System
1695,1688,54,mate,black,7,D02,Queen's Pawn Game: London System
1509,1609,52,resign,black,100,D02,Queen's Pawn Game: London System
2036,2054,89,resign,black,18,D02,Queen's Pawn Game: London System
2070,1968,129,resign,black,102,D02,Queen's Pawn Game: London System
1773,1706,64,mate,black,67,D02,Queen's Pawn Game: London System
1530,1502,60,resign,black,28,D02,Queen's Pawn Game: London System
1563,1335,44,resign,black,228,D00,Queen's Pawn Game: Mason Attack
1595,1547,54,resign,black,48,D00,Queen's Pawn Game: Mason Attack
1556,1539,48,resign,black,17,D00,Queen's Pawn Game: Mason Attack
1550,1605,96,resign,black,55,D00,Queen's Pawn Game: Mason Attack
2255,2425,36,resign,black,170,D00,Queen's Pawn Game: Mason Attack
2281,2400,21,resign,black,119,D00,Queen's Pawn Game: Mason Attack
1713,1637,118,resign,black,76,D00,Queen's Pawn Game: Mason Attack
1687,1771,81,resign,black,84,D00,Queen's Pawn Game: Mason Attack
1058,943,66,mate,black,115,D00,Queen's Pawn Game: Mason Attack
1099,1326,63,resign,black,227,D00,Queen's Pawn Game: Mason Attack
1413,1271,66,resign,black,142,D00,Queen's Pawn Game: Mason Attack
1451,1480,56,resign,black,29,D00,Queen's Pawn Game: Mason Attack
1374,1553,68,mate,black,179,D00,Queen's Pawn Game: Mason Attack
1580,1763,88,resign,black,183,D00,Queen's Pawn Game: Mason Attack
1966,2214,64,mate,black,248,D00,Queen's Pawn Game: Mason Attack
1852,1874,78,resign,black,22,D00,Queen's Pawn Game: Mason Attack
1863,1831,54,mate,black,32,D00,Queen's Pawn Game: Mason Attack
1653,1742,60,mate,black,89,D00,Queen's Pawn Game: Mason Attack
1311,1368,48,mate,black,57,D00,Queen's Pawn Game: Mason Attack
1760,1782,50,resign,black,22,D00,Queen's Pawn Game: Mason Attack
1836,1832,40,resign,black,4,D00,Queen's Pawn Game: Mason Attack
1451,1585,106,mate,black,134,D00,Queen's Pawn Game: Mason Attack
1868,1874,63,resign,black,6,D00,Queen's Pawn Game: Mason Attack
1908,1832,48,resign,black,76,D00,Queen's Pawn Game: Mason Attack
1874,1837,34,resign,black,37,D00,Queen's Pawn Game: Mason Attack
1838,1846,118,resign,black,8,D00,Queen's Pawn Game: Mason Attack
1784,1834,90,resign,black,50,D00,Queen's Pawn Game: Mason Attack
1796,1762,106,resign,black,34,D00,Queen's Pawn Game: Mason Attack
1804,1736,70,resign,black,68,D00,Queen's Pawn Game: Mason Attack
1813,1683,108,mate,black,130,D00,Queen's Pawn Game: Mason Attack
1214,1359,62,resign,black,145,D00,Queen's Pawn Game: Mason Attack
1757,1709,108,time,black,48,D00,Queen's Pawn Game: Mason Attack
1940,2220,28,resign,black,280,D00,Queen's Pawn Game: Mason Attack
1498,1503,66,mate,black,5,D00,Queen's Pawn Game: Mason Attack
1526,1443,77,resign,black,83,D00,Queen's Pawn Game: Mason Attack
1769,1624,42,resign,black,145,D00,Queen's Pawn Game: Mason Attack
1319,1343,76,mate,black,24,D00,Queen's Pawn Game: Mason Attack
1775,1946,58,resign,black,171,D00,Queen's Pawn Game: Mason Attack
1619,1483,46,resign,black,136,D00,Queen's Pawn Game: Mason Attack
1478,1461,76,mate,black,17,D00,Queen's Pawn Game: Mason Attack
1488,1490,58,mate,black,2,D00,Queen's Pawn Game: Mason Attack
1818,1860,78,resign,black,42,D00,Queen's Pawn Game: Steinitz Countergambit
1615,2264,64,resign,black,649,D00,Queen's Pawn Game: Stonewall Attack
1886,2001,25,resign,black,115,D00,Queen's Pawn Game: Stonewall Attack
1500,1507,42,mate,black,7,D00,Queen's Pawn Game: Stonewall Attack
1612,2011,56,mate,black,399,D00,Queen's Pawn Game: Stonewall Attack
1600,1880,62,mate,black,280,D00,Queen's Pawn Game: Stonewall Attack
1069,1071,60,mate,black,2,D02,Queen's Pawn Game: Symmetrical Variation
1708,1851,82,resign,black,143,D02,Queen's Pawn Game: Symmetrical Variation
1753,1451,98,mate,black,302,D02,Queen's Pawn Game: Symmetrical Variation
1745,1862,52,resign,black,117,D02,Queen's Pawn Game: Symmetrical Variation
1856,1819,114,mate,black,37,D02,Queen's Pawn Game: Symmetrical Variation
1788,2059,98,resign,black,271,D02,Queen's Pawn Game: Symmetrical Variation
1907,1770,20,resign,black,137,D02,Queen's Pawn Game: Symmetrical Variation
2151,2063,36,resign,black,88,D02,Queen's Pawn Game: Symmetrical Variation
1755,1722,126,resign,black,33,D02,Queen's Pawn Game: Symmetrical Variation
1243,1314,52,mate,black,71,D02,Queen's Pawn Game: Symmetrical Variation
2325,2338,62,resign,black,13,D02,Queen's Pawn Game: Symmetrical Variation |  Pseudo-Catalan
1954,1831,52,mate,black,123,D02,Queen's Pawn Game: Symmetrical Variation |  Pseudo-Catalan
1694,1520,82,mate,black,174,D02,Queen's Pawn Game: Symmetrical Variation |  Pseudo-Catalan
1837,1828,100,resign,black,9,D03,Queen's Pawn Game: Torre Attack
2126,2240,74,resign,black,114,D03,Queen's Pawn Game: Torre Attack
1480,1910,78,resign,black,430,D03,Queen's Pawn Game: Torre Attack
1062,1071,6,resign,black,9,D00,Queen's Pawn Game: Veresov Attack |  Alburt Defense
1631,1783,108,mate,black,152,D00,Queen's Pawn Game: Veresov Attack |  Alburt Defense
1263,1664,78,mate,black,401,D00,Queen's Pawn Game: Veresov Attack |  Anti-Veresov
1345,1398,114,resign,black,53,D01,Queen's Pawn Game: Veresov Attack |  Classical Defense
1865,1952,112,resign,black,87,D01,Queen's Pawn Game: Veresov Attack |  Classical Defense
1145,1428,32,mate,black,283,D01,Queen's Pawn Game: Veresov Attack |  Veresov Variation
1030,1162,50,mate,black,132,D02,Queen's Pawn Game: Zukertort Variation
1528,1369,65,resign,black,159,D02,Queen's Pawn Game: Zukertort Variation
1325,1174,62,resign,black,151,D02,Queen's Pawn Game: Zukertort Variation
1887,1760,60,resign,black,127,D02,Queen's Pawn Game: Zukertort Variation
1270,1322,48,mate,black,52,D02,Queen's Pawn Game: Zukertort Variation
1633,1777,88,resign,black,144,D02,Queen's Pawn Game: Zukertort Variation
1649,1838,45,resign,black,189,D02,Queen's Pawn Game: Zukertort Variation
1741,1771,42,mate,black,30,D02,Queen's Pawn Game: Zukertort Variation
1704,1852,38,resign,black,148,D02,Queen's Pawn Game: Zukertort Variation
1828,1697,76,mate,black,131,D02,Queen's Pawn Game: Zukertort Variation
1461,1785,72,resign,black,324,D02,Queen's Pawn Game: Zukertort Variation
1941,2034,68,resign,black,93,D02,Queen's Pawn Game: Zukertort Variation
1457,1510,24,mate,black,53,D02,Queen's Pawn Game: Zukertort Variation
1500,1272,76,mate,black,228,D02,Queen's Pawn Game: Zukertort Variation
1524,1414,36,resign,black,110,D02,Queen's Pawn Game: Zukertort Variation
1299,1400,55,resign,black,101,D02,Queen's Pawn Game: Zukertort Variation
1211,1354,62,mate,black,143,D02,Queen's Pawn Game: Zukertort Variation
1553,1677,46,resign,black,124,D02,Queen's Pawn Game: Zukertort Variation
1577,1730,90,mate,black,153,D02,Queen's Pawn Game: Zukertort Variation
1457,1466,68,mate,black,9,D02,Queen's Pawn Game: Zukertort Variation
1289,1825,46,resign,black,536,D02,Queen's Pawn Game: Zukertort Variation
1279,1207,44,mate,black,72,D00,Queen's Pawn Game: Zurich Gambit
1573,1715,112,resign,black,142,B07,Rat Defense: Antal Defense
1955,1885,34,resign,black,70,B07,Rat Defense: Antal Defense
1841,1688,32,resign,black,153,B07,Rat Defense: Balogh Defense
1851,1679,52,resign,black,172,B07,Rat Defense: Balogh Defense
1439,1453,64,resign,black,14,A41,Rat Defense: English Rat
1720,1383,88,time,black,337,A41,Rat Defense: English Rat |  Lisbon Gambit
1503,1569,62,mate,black,66,B07,Rat Defense: Harmonist
1282,1285,64,resign,black,3,C00,Rat Defense: Small Center Defense
1340,1548,100,mate,black,208,C00,Rat Defense: Small Center Defense
1130,1019,46,time,black,111,C00,Rat Defense: Small Center Defense
1594,1855,90,time,black,261,C00,Rat Defense: Small Center Defense
2245,2264,100,resign,black,19,C00,Rat Defense: Small Center Defense
1288,1952,132,mate,black,664,C00,Rat Defense: Small Center Defense
1750,1804,164,mate,black,54,A09,Reti Opening
2103,2198,42,resign,black,95,A06,Reti Opening
1036,1653,56,mate,black,617,A06,Reti Opening
1035,1401,10,time,black,366,A06,Reti Opening
1250,1428,88,resign,black,178,A06,Reti Opening
1957,2136,70,resign,black,179,A04,Reti Opening #2
1476,1387,20,resign,black,89,A04,Reti Opening #2
1025,1579,50,mate,black,554,A04,Reti Opening #2
1444,1815,52,resign,black,371,A04,Reti Opening #2
1034,1353,2,time,black,319,A04,Reti Opening #2
1870,1989,68,resign,black,119,A04,Reti Opening #2
1088,1350,80,resign,black,262,D01,Richter-Veresov Attack
1393,1357,86,mate,black,36,D01,Richter-Veresov Attack
1388,1444,56,resign,black,56,D01,Richter-Veresov Attack
976,1832,19,resign,black,856,B06,Robatsch (Modern) Defense
1538,1501,40,resign,black,37,B06,Robatsch (Modern) Defense
1731,2127,50,resign,black,396,B06,Robatsch (Modern) Defense
1884,2004,36,resign,black,120,B06,Robatsch (Modern) Defense
1345,1483,64,resign,black,138,B06,Robatsch (Modern) Defense
1440,1387,68,mate,black,53,B06,Robatsch (Modern) Defense
1452,1108,46,resign,black,344,B06,Robatsch (Modern) Defense
1821,2221,126,resign,black,400,B06,Robatsch (Modern) Defense
1759,1500,60,mate,black,259,C42,Russian Game: Classical Attack
1348,1652,92,resign,black,304,C42,Russian Game: Cochrane Gambit
1478,1560,50,resign,black,82,C42,Russian Game: Cozio (Lasker) Attack
1362,976,18,resign,black,386,C42,Russian Game: Damiano Variation
1391,1345,55,resign,black,46,C42,Russian Game: Damiano Variation
1228,1222,30,resign,black,6,C42,Russian Game: Damiano Variation
1388,2012,43,resign,black,624,C42,Russian Game: French Attack
1248,1291,32,resign,black,43,C43,Russian Game: Modern Attack |  Center Attack
1321,1283,36,resign,black,38,C43,Russian Game: Modern Attack |  Symmetrical Variation #2
1253,1232,64,resign,black,21,C42,Russian Game: Moody Gambit
2051,2147,42,resign,black,96,C42,Russian Game: Nimzowitsch Attack
1465,1706,46,mate,black,241,C42,Russian Game: Paulsen Attack
1347,1376,18,resign,black,29,C42,Russian Game: Stafford Gambit
1643,1722,116,time,black,79,C42,Russian Game: Three Knights Game
1728,1798,132,resign,black,70,C42,Russian Game: Three Knights Game
1855,2264,54,time,black,409,C42,Russian Game: Three Knights Game
1341,1391,138,mate,black,50,C42,Russian Game: Three Knights Game
1394,1358,30,resign,black,36,C42,Russian Game: Three Knights Game
1706,1839,25,resign,black,133,C42,Russian Game: Three Knights Game
1637,1630,92,time,black,7,C42,Russian Game: Three Knights Game
1529,1518,58,resign,black,11,C42,Russian Game: Three Knights Game
1490,1500,30,resign,black,10,C42,Russian Game: Three Knights Game
1646,1573,15,resign,black,73,C42,Russian Game: Three Knights Game
1547,1891,32,mate,black,344,C42,Russian Game: Urusov Gambit
1358,1420,52,mate,black,62,C42,Russian Game: Urusov Gambit
1514,1515,16,resign,black,1,C42,Russian Game: Urusov Gambit
1155,1483,16,mate,black,328,C42,Russian Game: Urusov Gambit
1521,1484,68,mate,black,37,C42,Russian Game: Urusov Gambit
1134,1372,26,mate,black,238,C42,Russian Game: Urusov Gambit
1263,1554,52,mate,black,291,C42,Russian Game: Urusov Gambit
1262,1401,43,resign,black,139,C42,Russian Game: Urusov Gambit
1350,1501,22,mate,black,151,C42,Russian Game: Urusov Gambit
1096,1135,82,mate,black,39,C42,Russian Game: Urusov Gambit
981,1127,58,mate,black,146,C70,Ruy Lopez
1245,1228,52,time,black,17,C60,Ruy Lopez
1735,1733,47,resign,black,2,C60,Ruy Lopez
1610,1691,64,resign,black,81,C60,Ruy Lopez
1553,1953,60,resign,black,400,C60,Ruy Lopez
1502,1530,132,mate,black,28,C60,Ruy Lopez
1768,1754,30,resign,black,14,C60,Ruy Lopez
1167,1346,44,mate,black,179,C70,Ruy Lopez
1612,1891,40,resign,black,279,C60,Ruy Lopez
1224,1372,30,time,black,148,C60,Ruy Lopez
1167,1122,34,resign,black,45,C65,Ruy Lopez: Berlin Defense #2
2063,2183,66,resign,black,120,C65,Ruy Lopez: Berlin Defense #2
2188,2234,133,resign,black,46,C65,Ruy Lopez: Berlin Defense #2
1719,1765,94,mate,black,46,C65,Ruy Lopez: Berlin Defense #2
1714,1771,44,mate,black,57,C65,Ruy Lopez: Berlin Defense #2
1362,1458,80,mate,black,96,C65,Ruy Lopez: Berlin Defense #2
1302,1696,56,mate,black,394,C65,Ruy Lopez: Berlin Defense #2
2009,1404,54,resign,black,605,C65,Ruy Lopez: Berlin Defense #2
1341,1484,30,resign,black,143,C65,Ruy Lopez: Berlin Defense #2
1499,1519,56,resign,black,20,C65,Ruy Lopez: Berlin Defense #2
1397,1459,49,resign,black,62,C65,Ruy Lopez: Berlin Defense #2
1461,1364,23,resign,black,97,C65,Ruy Lopez: Berlin Defense #2
2063,1500,62,resign,black,563,C65,Ruy Lopez: Berlin Defense #2
1299,2221,44,resign,black,922,C65,Ruy Lopez: Berlin Defense #2
1472,1599,24,resign,black,127,C65,Ruy Lopez: Berlin Defense #2
1202,1513,36,resign,black,311,C65,Ruy Lopez: Berlin Defense #2
2130,2296,130,resign,black,166,C65,Ruy Lopez: Berlin Defense |  Beverwijk Variation
1581,1596,50,resign,black,15,C65,Ruy Lopez: Berlin Defense |  Beverwijk Variation
1910,1979,136,time,black,69,C65,Ruy Lopez: Berlin Defense |  Beverwijk Variation
1856,1903,53,resign,black,47,C66,Ruy Lopez: Berlin Defense |  Improved Steinitz Defense
1742,1750,90,resign,black,8,C66,Ruy Lopez: Berlin Defense |  Improved Steinitz Defense
1288,1368,56,resign,black,80,C66,Ruy Lopez: Berlin Defense |  Improved Steinitz Defense
1647,1562,51,resign,black,85,C66,Ruy Lopez: Berlin Defense |  Improved Steinitz Defense
2133,2124,124,time,black,9,C67,Ruy Lopez: Berlin Defense |  Rio Gambit Accepted
1860,1496,88,mate,black,364,C67,Ruy Lopez: Berlin Defense |  Rio Gambit Accepted
1877,1860,69,resign,black,17,C61,Ruy Lopez: Bird Variation
1461,1490,74,resign,black,29,C61,Ruy Lopez: Bird Variation
1461,1357,52,mate,black,104,C61,Ruy Lopez: Bird Variation
1476,1316,14,resign,black,160,C61,Ruy Lopez: Bird Variation
1167,1627,26,mate,black,460,C61,Ruy Lopez: Bird Variation
1456,1369,47,resign,black,87,C61,Ruy Lopez: Bird Variation
1823,1880,74,resign,black,57,C61,Ruy Lopez: Bird Variation
1795,1784,54,mate,black,11,C64,Ruy Lopez: Classical Variation
1178,1391,58,resign,black,213,C64,Ruy Lopez: Classical Variation
1374,1613,35,resign,black,239,C64,Ruy Lopez: Classical Variation
1460,1327,24,mate,black,133,C64,Ruy Lopez: Classical Variation
1455,1480,28,resign,black,25,C64,Ruy Lopez: Classical Variation
1547,1801,36,mate,black,254,C64,Ruy Lopez: Classical Variation
1427,1389,26,resign,black,38,C64,Ruy Lopez: Classical Variation
1686,1731,42,resign,black,45,C64,Ruy Lopez: Classical Variation
1553,1717,128,resign,black,164,C64,Ruy Lopez: Classical Variation
1500,1288,110,resign,black,212,C64,Ruy Lopez: Classical Variation
1161,1297,28,mate,black,136,C64,Ruy Lopez: Classical Variation
1884,1768,90,resign,black,116,C64,Ruy Lopez: Classical Variation |  Central Variation
1885,2107,168,mate,black,222,C64,Ruy Lopez: Classical Variation |  Modern Main Line
2271,2322,110,resign,black,51,C64,Ruy Lopez: Classical Variation |  Zukertort Gambit
1891,1814,129,resign,black,77,C88,Ruy Lopez: Closed
2070,2203,76,mate,black,133,C88,Ruy Lopez: Closed
1540,1703,64,resign,black,163,C88,Ruy Lopez: Closed
1603,2001,48,resign,black,398,C88,Ruy Lopez: Closed
1303,1175,64,mate,black,128,C84,Ruy Lopez: Closed Variations
1865,1617,75,resign,black,248,C92,Ruy Lopez: Closed Variations |  Flohr System
1558,1358,34,resign,black,200,C88,Ruy Lopez: Closed Variations |  Rosen Attack
1200,1252,100,mate,black,52,C91,Ruy Lopez: Closed Variations |  Yates Variation
1264,1288,74,mate,black,24,C91,Ruy Lopez: Closed Variations |  Yates Variation
1679,2293,33,resign,black,614,C91,Ruy Lopez: Closed Variations |  Yates Variation |  Short Attack
1623,1623,106,mate,black,0,C60,Ruy Lopez: Cozio Defense
1414,1624,92,mate,black,210,C60,Ruy Lopez: Cozio Defense
1250,1286,70,mate,black,36,C60,Ruy Lopez: Cozio Defense
1220,1407,48,mate,black,187,C60,Ruy Lopez: Cozio Defense
1534,1528,64,mate,black,6,C60,Ruy Lopez: Cozio Defense
2050,2044,72,time,black,6,C60,Ruy Lopez: Cozio Defense
2003,2040,168,time,black,37,C60,Ruy Lopez: Cozio Defense
1966,1616,6,time,black,350,C60,Ruy Lopez: Cozio Defense
1668,1808,28,resign,black,140,C60,Ruy Lopez: Cozio Defense
1528,1564,174,mate,black,36,C68,Ruy Lopez: Exchange Variation
1509,1439,16,resign,black,70,C68,Ruy Lopez: Exchange Variation
1455,1569,42,mate,black,114,C68,Ruy Lopez: Exchange Variation
1357,1369,59,resign,black,12,C68,Ruy Lopez: Exchange Variation
1895,1953,40,time,black,58,C69,Ruy Lopez: Exchange Variation |  Gligoric Variation
1030,1352,104,resign,black,322,C68,Ruy Lopez: Exchange Variation |  King's Bishop Variation
1674,1862,20,resign,black,188,C68,Ruy Lopez: Exchange Variation |  King's Bishop Variation
1386,1683,114,mate,black,297,C68,Ruy Lopez: Exchange Variation |  King's Bishop Variation
1511,1490,42,mate,black,21,C68,Ruy Lopez: Exchange Variation |  Lutikov Variation
1495,1831,50,resign,black,336,C68,Ruy Lopez: Exchange Variation |  Lutikov Variation
1464,1495,67,resign,black,31,C69,Ruy Lopez: Exchange Variation |  Normal Variation
1941,1925,56,resign,black,16,C69,Ruy Lopez: Exchange Variation |  Normal Variation
1934,1949,114,mate,black,15,C69,Ruy Lopez: Exchange Variation |  Normal Variation
1526,2229,72,resign,black,703,C69,Ruy Lopez: Exchange Variation |  Normal Variation
1106,1143,122,mate,black,37,C60,Ruy Lopez: Fianchetto Defense
1601,1943,56,resign,black,342,C60,Ruy Lopez: Fianchetto Defense
1486,2125,42,mate,black,639,C78,Ruy Lopez: Morphy Defense
2140,2244,52,resign,black,104,C78,Ruy Lopez: Morphy Defense
1880,1828,38,resign,black,52,C77,Ruy Lopez: Morphy Defense |  Anderssen Variation
1916,1842,32,resign,black,74,C77,Ruy Lopez: Morphy Defense |  Anderssen Variation
1739,2143,83,resign,black,404,C77,Ruy Lopez: Morphy Defense |  Anderssen Variation
2009,2126,106,time,black,117,C77,Ruy Lopez: Morphy Defense |  Anderssen Variation
1799,1611,60,mate,black,188,C77,Ruy Lopez: Morphy Defense |  Anderssen Variation
2227,2271,98,resign,black,44,C77,Ruy Lopez: Morphy Defense |  Anderssen Variation
1557,1547,48,resign,black,10,C70,Ruy Lopez: Morphy Defense |  Caro Variation
1164,1263,92,resign,black,99,C70,Ruy Lopez: Morphy Defense |  Caro Variation
1259,1417,34,resign,black,158,C70,Ruy Lopez: Morphy Defense |  Caro Variation
1895,1813,54,resign,black,82,C74,Ruy Lopez: Morphy Defense |  Modern Steinitz Defense
2451,2270,56,resign,black,181,C72,Ruy Lopez: Morphy Defense |  Modern Steinitz Defense
1678,2205,73,resign,black,527,C72,Ruy Lopez: Morphy Defense |  Modern Steinitz Defense
1389,1755,80,mate,black,366,C70,Ruy Lopez: Morphy Defense |  Schliemann Defense Deferred
1289,2108,28,resign,black,819,C77,Ruy Lopez: Morphy Defense |  Tarrasch Variation
2015,2397,98,resign,black,382,C77,Ruy Lopez: Morphy Defense |  Tarrasch Variation
1286,1502,98,resign,black,216,C77,Ruy Lopez: Morphy Defense |  Tarrasch Variation
1778,2264,92,mate,black,486,C77,Ruy Lopez: Morphy Defense |  Wormald Attack
2458,2424,64,resign,black,34,C81,Ruy Lopez: Open Variations |  Howell Attack #2
1673,2300,94,resign,black,627,C81,Ruy Lopez: Open Variations |  Howell Attack #2
1833,1609,41,resign,black,224,C80,Ruy Lopez: Open Variations |  Open Variation
1570,2090,10,resign,black,520,C60,Ruy Lopez: Schliemann Defense |  Jaenisch Gambit Accepted
1142,1150,14,resign,black,8,C60,Ruy Lopez: Spanish Countergambit
1453,1466,102,mate,black,13,C62,Ruy Lopez: Steinitz Defense
1437,1476,68,resign,black,39,C62,Ruy Lopez: Steinitz Defense
1705,1719,54,resign,black,14,C62,Ruy Lopez: Steinitz Defense
1268,1392,72,mate,black,124,C62,Ruy Lopez: Steinitz Defense
1686,1701,90,resign,black,15,C62,Ruy Lopez: Steinitz Defense
1890,1853,66,resign,black,37,C62,Ruy Lopez: Steinitz Defense
1616,1504,24,resign,black,112,C62,Ruy Lopez: Steinitz Defense
1391,1774,26,mate,black,383,C62,Ruy Lopez: Steinitz Defense
1545,1461,94,resign,black,84,C62,Ruy Lopez: Steinitz Defense
1488,1478,60,mate,black,10,C62,Ruy Lopez: Steinitz Defense
1696,1797,46,time,black,101,C62,Ruy Lopez: Steinitz Defense
1500,1810,42,mate,black,310,C62,Ruy Lopez: Steinitz Defense
1404,1326,88,resign,black,78,C62,Ruy Lopez: Steinitz Defense
1678,1675,20,resign,black,3,C62,Ruy Lopez: Steinitz Defense
1365,1751,24,resign,black,386,C62,Ruy Lopez: Steinitz Defense
1670,1881,14,resign,black,211,C62,Ruy Lopez: Steinitz Defense
1500,1621,62,mate,black,121,C62,Ruy Lopez: Steinitz Defense
2201,2266,58,resign,black,65,C62,Ruy Lopez: Steinitz Defense
1571,1389,74,resign,black,182,C62,Ruy Lopez: Steinitz Defense
1418,1432,44,mate,black,14,C62,Ruy Lopez: Steinitz Defense
1732,1839,32,resign,black,107,C62,Ruy Lopez: Steinitz Defense
1650,1585,29,resign,black,65,C62,Ruy Lopez: Steinitz Defense
1622,1694,74,mate,black,72,C62,Ruy Lopez: Steinitz Defense |  Nimzowitsch Attack
1746,1466,98,resign,black,280,C60,Ruy Lopez: Vinogradov Variation
1290,1436,42,resign,black,146,A00,Saragossa Opening
1303,1876,42,mate,black,573,A00,Saragossa Opening
1313,1401,34,mate,black,88,A00,Saragossa Opening
1319,1363,86,resign,black,44,A00,Saragossa Opening
1491,1541,90,resign,black,50,A00,Saragossa Opening
1442,1609,92,time,black,167,A00,Saragossa Opening
1453,1558,16,resign,black,105,A00,Saragossa Opening
1183,1554,66,mate,black,371,A00,Saragossa Opening
1505,1914,50,resign,black,409,A00,Saragossa Opening
1036,1179,26,resign,black,143,A00,Saragossa Opening
1546,1560,72,resign,black,14,A00,Saragossa Opening
1307,1218,60,time,black,89,A00,Saragossa Opening
966,1124,58,resign,black,158,B01,Scandinavian Defense
1500,1500,40,resign,black,0,B01,Scandinavian Defense
1170,1662,64,mate,black,492,B01,Scandinavian Defense
1331,1341,44,mate,black,10,B01,Scandinavian Defense
1336,1516,2,time,black,180,B01,Scandinavian Defense
1359,1411,34,resign,black,52,B01,Scandinavian Defense
1503,1498,52,mate,black,5,B01,Scandinavian Defense
1426,1885,60,mate,black,459,B01,Scandinavian Defense
1303,1248,22,mate,black,55,B01,Scandinavian Defense
1227,1312,30,mate,black,85,B01,Scandinavian Defense
1279,1406,42,mate,black,127,B01,Scandinavian Defense
1355,1428,76,mate,black,73,B01,Scandinavian Defense
1406,1423,48,resign,black,17,B01,Scandinavian Defense
1364,1397,80,resign,black,33,B01,Scandinavian Defense
1599,1499,60,resign,black,100,B01,Scandinavian Defense
1058,1249,42,resign,black,191,B01,Scandinavian Defense
1110,1320,34,mate,black,210,B01,Scandinavian Defense
1140,1011,90,mate,black,129,B01,Scandinavian Defense
1172,1077,38,mate,black,95,B01,Scandinavian Defense
1317,1538,18,resign,black,221,B01,Scandinavian Defense
1141,1168,56,time,black,27,B01,Scandinavian Defense
1600,1521,116,mate,black,79,B01,Scandinavian Defense
1423,1614,102,mate,black,191,B01,Scandinavian Defense
1377,1520,50,mate,black,143,B01,Scandinavian Defense
1166,1061,61,resign,black,105,B01,Scandinavian Defense
1079,1325,86,mate,black,246,B01,Scandinavian Defense
1145,1174,20,resign,black,29,B01,Scandinavian Defense
1141,1175,4,resign,black,34,B01,Scandinavian Defense
1018,1142,44,mate,black,124,B01,Scandinavian Defense
1362,1157,66,mate,black,205,B01,Scandinavian Defense
1275,1286,58,resign,black,11,B01,Scandinavian Defense
1298,1244,22,resign,black,54,B01,Scandinavian Defense
1318,1318,28,mate,black,0,B01,Scandinavian Defense
1030,1501,28,resign,black,471,B01,Scandinavian Defense
1286,1160,23,resign,black,126,B01,Scandinavian Defense
1269,1625,16,resign,black,356,B01,Scandinavian Defense
1525,1370,106,time,black,155,B01,Scandinavian Defense
1543,1772,116,mate,black,229,B01,Scandinavian Defense
1846,1839,72,mate,black,7,B01,Scandinavian Defense
1299,1356,46,resign,black,57,B01,Scandinavian Defense
1433,2267,70,resign,black,834,B01,Scandinavian Defense
1301,2266,80,mate,black,965,B01,Scandinavian Defense
1266,1254,34,resign,black,12,B01,Scandinavian Defense
1033,1415,32,mate,black,382,B01,Scandinavian Defense
1839,2085,70,resign,black,246,B01,Scandinavian Defense
2063,2271,66,resign,black,208,B01,Scandinavian Defense
1916,1996,132,resign,black,80,B01,Scandinavian Defense
1901,2024,24,resign,black,123,B01,Scandinavian Defense
1710,1911,70,mate,black,201,B01,Scandinavian Defense
1135,1125,74,mate,black,10,B01,Scandinavian Defense
1511,1614,48,resign,black,103,B01,Scandinavian Defense
1411,1411,54,mate,black,0,B01,Scandinavian Defense: Blackburne Gambit
1337,1391,28,time,black,54,B01,Scandinavian Defense: Blackburne Gambit
1386,1442,82,mate,black,56,B01,Scandinavian Defense: Blackburne Gambit
1387,1406,38,mate,black,19,B01,Scandinavian Defense: Blackburne Gambit
1280,1413,46,resign,black,133,B01,Scandinavian Defense: Blackburne Gambit
1563,1697,64,resign,black,134,B01,Scandinavian Defense: Blackburne Gambit
1682,1744,58,resign,black,62,B01,Scandinavian Defense: Blackburne Gambit
1891,1793,50,resign,black,98,B01,Scandinavian Defense: Blackburne-Kloosterboer Gambit
1375,1396,69,resign,black,21,B01,Scandinavian Defense: Blackburne-Kloosterboer Gambit
1684,1435,46,resign,black,249,B01,Scandinavian Defense: Blackburne-Kloosterboer Gambit
1370,1606,76,resign,black,236,B01,Scandinavian Defense: Boehnke Gambit
1394,1610,112,resign,black,216,B01,Scandinavian Defense: Boehnke Gambit
1411,1404,48,mate,black,7,B01,Scandinavian Defense: Boehnke Gambit
1099,1052,48,resign,black,47,B01,Scandinavian Defense: Gubinsky-Melts Defense
1605,1546,80,resign,black,59,B01,Scandinavian Defense: Icelandic-Palme Gambit
1599,1929,34,mate,black,330,B01,Scandinavian Defense: Icelandic-Palme Gambit
1882,1919,94,resign,black,37,B01,Scandinavian Defense: Icelandic-Palme Gambit
1853,1853,66,time,black,0,B01,Scandinavian Defense: Icelandic-Palme Gambit
1882,1840,20,resign,black,42,B01,Scandinavian Defense: Icelandic-Palme Gambit
1859,1945,64,mate,black,86,B01,Scandinavian Defense: Icelandic-Palme Gambit
1754,1824,104,time,black,70,B01,Scandinavian Defense: Icelandic-Palme Gambit
1353,1542,26,resign,black,189,B01,Scandinavian Defense: Icelandic-Palme Gambit
1802,2054,46,resign,black,252,B01,Scandinavian Defense: Icelandic-Palme Gambit
1919,2037,30,resign,black,118,B01,Scandinavian Defense: Icelandic-Palme Gambit
2039,1996,31,resign,black,43,B01,Scandinavian Defense: Icelandic-Palme Gambit
2041,1992,60,resign,black,49,B01,Scandinavian Defense: Icelandic-Palme Gambit
1026,1215,110,mate,black,189,B01,Scandinavian Defense: Main Line
1392,1549,36,mate,black,157,B01,Scandinavian Defense: Main Line
1428,1222,36,resign,black,206,B01,Scandinavian Defense: Main Line
1757,1895,62,resign,black,138,B01,Scandinavian Defense: Main Line
1261,1697,48,time,black,436,B01,Scandinavian Defense: Main Line
1506,1610,52,resign,black,104,B01,Scandinavian Defense: Main Line
1621,1487,100,time,black,134,B01,Scandinavian Defense: Main Line
1533,1543,18,resign,black,10,B01,Scandinavian Defense: Main Line
1389,1540,42,resign,black,151,B01,Scandinavian Defense: Main Line
1540,1516,96,time,black,24,B01,Scandinavian Defense: Main Line
1942,1951,58,resign,black,9,B01,Scandinavian Defense: Main Line
1775,2179,36,mate,black,404,B01,Scandinavian Defense: Main Line
1835,2266,50,mate,black,431,B01,Scandinavian Defense: Main Line
2123,2116,72,resign,black,7,B01,Scandinavian Defense: Main Line |  Leonhardt Gambit
2043,2032,68,mate,black,11,B01,Scandinavian Defense: Main Line |  Mieses Variation
1878,1698,16,resign,black,180,B01,Scandinavian Defense: Marshall Variation
1858,1790,30,resign,black,68,B01,Scandinavian Defense: Mieses-Kotroc Variation
1830,1809,76,time,black,21,B01,Scandinavian Defense: Mieses-Kotroc Variation
1155,1484,22,resign,black,329,B01,Scandinavian Defense: Mieses-Kotroc Variation
1510,1461,132,mate,black,49,B01,Scandinavian Defense: Mieses-Kotroc Variation
1007,1208,66,mate,black,201,B01,Scandinavian Defense: Mieses-Kotroc Variation
1405,1362,86,mate,black,43,B01,Scandinavian Defense: Mieses-Kotroc Variation
1343,1328,34,mate,black,15,B01,Scandinavian Defense: Mieses-Kotroc Variation
1370,1838,36,resign,black,468,B01,Scandinavian Defense: Mieses-Kotroc Variation
1317,1392,12,resign,black,75,B01,Scandinavian Defense: Mieses-Kotroc Variation
1365,1708,30,resign,black,343,B01,Scandinavian Defense: Mieses-Kotroc Variation
1334,1277,44,resign,black,57,B01,Scandinavian Defense: Mieses-Kotroc Variation
1374,1357,102,mate,black,17,B01,Scandinavian Defense: Mieses-Kotroc Variation
1573,1866,14,mate,black,293,B01,Scandinavian Defense: Mieses-Kotroc Variation
1594,1852,41,resign,black,258,B01,Scandinavian Defense: Mieses-Kotroc Variation
1651,1878,50,mate,black,227,B01,Scandinavian Defense: Mieses-Kotroc Variation
1160,796,60,mate,black,364,B01,Scandinavian Defense: Mieses-Kotroc Variation
1418,1741,32,mate,black,323,B01,Scandinavian Defense: Mieses-Kotroc Variation
1436,1389,43,resign,black,47,B01,Scandinavian Defense: Mieses-Kotroc Variation
1136,1344,44,mate,black,208,B01,Scandinavian Defense: Mieses-Kotroc Variation
1759,1532,126,time,black,227,B01,Scandinavian Defense: Mieses-Kotroc Variation
1556,1420,48,resign,black,136,B01,Scandinavian Defense: Mieses-Kotroc Variation
1572,1544,42,time,black,28,B01,Scandinavian Defense: Mieses-Kotroc Variation
1880,1320,70,resign,black,560,B01,Scandinavian Defense: Mieses-Kotroc Variation
1565,1712,56,mate,black,147,B01,Scandinavian Defense: Mieses-Kotroc Variation
1439,1493,52,mate,black,54,B01,Scandinavian Defense: Mieses-Kotroc Variation
1027,1084,12,resign,black,57,B01,Scandinavian Defense: Mieses-Kotroc Variation
1714,1676,66,mate,black,38,B01,Scandinavian Defense: Mieses-Kotroc Variation
1787,1533,134,mate,black,254,B01,Scandinavian Defense: Mieses-Kotroc Variation
1278,1568,24,resign,black,290,B01,Scandinavian Defense: Mieses-Kotroc Variation
1483,1287,112,mate,black,196,B01,Scandinavian Defense: Mieses-Kotroc Variation
1341,1398,80,mate,black,57,B01,Scandinavian Defense: Mieses-Kotroc Variation
1482,1741,72,mate,black,259,B01,Scandinavian Defense: Mieses-Kotroc Variation
1456,1765,64,mate,black,309,B01,Scandinavian Defense: Mieses-Kotroc Variation
1576,1683,46,resign,black,107,B01,Scandinavian Defense: Mieses-Kotroc Variation
2143,2032,168,time,black,111,B01,Scandinavian Defense: Mieses-Kotroc Variation
1720,1748,100,mate,black,28,B01,Scandinavian Defense: Mieses-Kotroc Variation
1037,1541,108,mate,black,504,B01,Scandinavian Defense: Mieses-Kotroc Variation
2057,2093,118,resign,black,36,B01,Scandinavian Defense: Mieses-Kotroc Variation
2054,2066,76,resign,black,12,B01,Scandinavian Defense: Mieses-Kotroc Variation
1505,1510,70,resign,black,5,B01,Scandinavian Defense: Mieses-Kotroc Variation
1489,1501,38,resign,black,12,B01,Scandinavian Defense: Mieses-Kotroc Variation
1421,1429,64,resign,black,8,B01,Scandinavian Defense: Mieses-Kotroc Variation
1435,1383,130,time,black,52,B01,Scandinavian Defense: Mieses-Kotroc Variation
1897,2183,72,resign,black,286,B01,Scandinavian Defense: Mieses-Kotroc Variation
1672,1706,22,resign,black,34,B01,Scandinavian Defense: Mieses-Kotroc Variation
1699,1914,122,mate,black,215,B01,Scandinavian Defense: Modern Variation
1727,1574,70,time,black,153,B01,Scandinavian Defense: Modern Variation #2
1590,1515,62,mate,black,75,B01,Scandinavian Defense: Modern Variation #2
1482,1484,56,resign,black,2,B01,Scandinavian Defense: Modern Variation #2
1758,1929,116,resign,black,171,B01,Scandinavian Defense: Modern Variation #2
1660,1873,70,mate,black,213,B01,Scandinavian Defense: Modern Variation #2
1356,1461,90,mate,black,105,B01,Scandinavian Defense: Modern Variation #2
1640,1556,50,resign,black,84,B01,Scandinavian Defense: Modern Variation #2
1600,1542,26,resign,black,58,B01,Scandinavian Defense: Modern Variation #2
1706,1540,46,resign,black,166,B01,Scandinavian Defense: Modern Variation #2
1469,1476,30,time,black,7,B01,Scandinavian Defense: Modern Variation #2
1297,2027,39,resign,black,730,B01,Scandinavian Defense: Modern Variation #2
1779,1496,55,resign,black,283,B01,Scandinavian Defense: Modern Variation #2
1159,1745,34,time,black,586,B01,Scandinavian Defense: Modern Variation #2
2017,2020,86,resign,black,3,B01,Scandinavian Defense: Modern Variation #2
1228,1343,50,resign,black,115,B01,Scandinavian Defense: Panov Transfer
1675,1505,52,mate,black,170,B01,Scandinavian Defense: Panov Transfer
1547,1491,26,mate,black,56,B01,Scandinavian Defense: Panov Transfer
1891,1845,44,resign,black,46,B01,Scandinavian Defense: Panov Transfer
2366,2264,52,resign,black,102,B01,Scandinavian Defense: Panov Transfer
1791,2060,22,resign,black,269,B01,Scandinavian Defense: Panov Transfer
2025,2040,82,resign,black,15,B01,Scandinavian Defense: Portuguese Variation
1829,2008,20,resign,black,179,B01,Scandinavian Defense: Portuguese Variation
1907,1981,118,time,black,74,B01,Scandinavian Defense: Portuguese Variation
1457,1294,44,resign,black,163,C44,Scotch Game
1479,1454,59,resign,black,25,C45,Scotch Game
1854,1730,77,resign,black,124,C45,Scotch Game
1324,1365,90,time,black,41,C45,Scotch Game
1317,1401,28,mate,black,84,C45,Scotch Game
1498,1597,81,resign,black,99,C45,Scotch Game
1139,1104,28,mate,black,35,C44,Scotch Game
1690,2141,25,resign,black,451,C45,Scotch Game
1652,1708,18,mate,black,56,C44,Scotch Game
1525,1494,109,resign,black,31,C44,Scotch Game
1538,1452,13,resign,black,86,C44,Scotch Game
1541,1900,66,mate,black,359,C45,Scotch Game
1349,1497,60,time,black,148,C44,Scotch Game
1360,1764,44,time,black,404,C45,Scotch Game
1342,1546,46,resign,black,204,C45,Scotch Game
1392,1488,30,resign,black,96,C44,Scotch Game
1597,1543,70,resign,black,54,C45,Scotch Game
1421,1754,112,mate,black,333,C45,Scotch Game
1443,1471,80,mate,black,28,C44,Scotch Game
1146,1355,78,mate,black,209,C44,Scotch Game
1555,1844,46,mate,black,289,C45,Scotch Game
1836,1741,46,resign,black,95,C45,Scotch Game
1172,1760,60,mate,black,588,C45,Scotch Game
1987,1900,146,time,black,87,C45,Scotch Game
1872,1973,48,resign,black,101,C45,Scotch Game
1606,1637,66,resign,black,31,C44,Scotch Game
1402,1682,42,resign,black,280,C45,Scotch Game
1570,1587,24,resign,black,17,C44,Scotch Game
1589,1573,69,resign,black,16,C44,Scotch Game
1588,1595,56,resign,black,7,C44,Scotch Game
1641,1638,50,resign,black,3,C45,Scotch Game
1634,1619,66,resign,black,15,C44,Scotch Game
1532,1597,86,resign,black,65,C45,Scotch Game
1557,1409,50,resign,black,148,C44,Scotch Game
1336,1324,34,resign,black,12,C44,Scotch Game
2005,2024,156,resign,black,19,C45,Scotch Game
1334,1253,112,mate,black,81,C44,Scotch Game
1141,1328,6,resign,black,187,C44,Scotch Game
1315,1390,46,resign,black,75,C45,Scotch Game
1314,1295,50,resign,black,19,C45,Scotch Game
1313,1383,46,mate,black,70,C44,Scotch Game
1546,1595,50,resign,black,49,C45,Scotch Game
1535,1484,82,time,black,51,C44,Scotch Game
1568,1534,60,resign,black,34,C45,Scotch Game
1540,1556,26,resign,black,16,C45,Scotch Game
1563,1654,36,resign,black,91,C44,Scotch Game
1562,1480,68,resign,black,82,C44,Scotch Game
1483,1533,62,resign,black,50,C45,Scotch Game
1679,1705,110,resign,black,26,C45,Scotch Game
2011,1828,58,resign,black,183,C45,Scotch Game
1312,1422,148,resign,black,110,C44,Scotch Game
1331,1401,66,resign,black,70,C45,Scotch Game
1381,1377,48,resign,black,4,C45,Scotch Game
1439,1426,39,resign,black,13,C45,Scotch Game
1447,1499,35,resign,black,52,C44,Scotch Game
1896,1644,71,resign,black,252,C45,Scotch Game
1267,1641,94,mate,black,374,C44,Scotch Game: Benima Defense
1788,2207,39,resign,black,419,C45,Scotch Game: Blumenfeld Attack
1867,1883,92,resign,black,16,C45,Scotch Game: Classical Variation
1757,1893,52,mate,black,136,C45,Scotch Game: Classical Variation
989,1658,30,resign,black,669,C45,Scotch Game: Classical Variation
1538,1553,68,resign,black,15,C45,Scotch Game: Classical Variation
1585,1502,50,resign,black,83,C45,Scotch Game: Classical Variation
1430,1805,52,mate,black,375,C45,Scotch Game: Classical Variation
2057,2126,62,resign,black,69,C45,Scotch Game: Classical Variation |  Intermezzo Variation
1595,1581,24,resign,black,14,C45,Scotch Game: Classical Variation |  Intermezzo Variation
1183,1552,42,resign,black,369,C45,Scotch Game: Classical Variation |  Intermezzo Variation
1431,1516,62,resign,black,85,C45,Scotch Game: Fraser Variation
1652,1624,58,resign,black,28,C45,Scotch Game: Malaniuk Variation
1303,1705,24,resign,black,402,C45,Scotch Game: Malaniuk Variation
1360,1432,36,resign,black,72,C45,Scotch Game: Modern Defense
1387,1621,14,resign,black,234,C45,Scotch Game: Modern Defense
1972,2072,76,resign,black,100,C45,Scotch Game: Modern Defense
1732,1768,90,resign,black,36,C45,Scotch Game: Paulsen Attack
1994,2023,30,time,black,29,C45,Scotch Game: Potter Variation
1796,1680,36,mate,black,116,C45,Scotch Game: Schmidt Variation
1506,1565,40,mate,black,59,C45,Scotch Game: Schmidt Variation
1527,1400,40,resign,black,127,C45,Scotch Game: Schmidt Variation
1916,1222,41,resign,black,694,C45,Scotch Game: Scotch Gambit |  Advance Variation
1773,1495,28,mate,black,278,C45,Scotch Game: Scotch Gambit |  Advance Variation
1537,1509,90,resign,black,28,C44,Scotch Game: Scotch Gambit |  Dubois Reti Defense
1737,1601,42,mate,black,136,C44,Scotch Game: Scotch Gambit |  Dubois Reti Defense
1874,1949,38,mate,black,75,C44,Scotch Game: Scotch Gambit |  Dubois Reti Defense
1673,2126,32,resign,black,453,C45,Scotch Game: Scotch Gambit |  Kingside Variation
1324,1440,30,resign,black,116,C44,Scotch Game: Scotch Gambit |  Sarratt Variation
1232,2017,62,mate,black,785,C45,Scotch Game: Steinitz Variation
1952,2179,54,resign,black,227,D43,Semi-Slav Defense
1566,2254,64,mate,black,688,D43,Semi-Slav Defense
1840,1914,30,resign,black,74,D43,Semi-Slav Defense
1299,1418,30,resign,black,119,D31,Semi-Slav Defense: Accelerated Move Order
1739,1797,38,resign,black,58,D31,Semi-Slav Defense: Accelerated Move Order
2182,2184,92,resign,black,2,D31,Semi-Slav Defense: Accelerated Move Order
1336,1786,56,time,black,450,D31,Semi-Slav Defense: Accelerated Move Order
1769,1639,82,resign,black,130,D31,Semi-Slav Defense: Accelerated Move Order
1654,1839,64,mate,black,185,D45,Semi-Slav Defense: Main Line
1858,1888,86,resign,black,30,D45,Semi-Slav Defense: Normal Variation
1900,1900,58,resign,black,0,D31,Semi-Slav Defense: Noteboom Variation |  Abrahams Variation
1868,2220,44,resign,black,352,D30,Semi-Slav Defense: Quiet Variation
1800,1826,136,resign,black,26,B20,Sicilian Defense
1631,1684,69,resign,black,53,B50,Sicilian Defense
1287,1099,70,time,black,188,B20,Sicilian Defense
1553,1542,96,resign,black,11,B20,Sicilian Defense
901,1339,40,mate,black,438,B20,Sicilian Defense
1412,1427,62,resign,black,15,B20,Sicilian Defense
1721,1754,94,mate,black,33,B50,Sicilian Defense
1037,1669,88,mate,black,632,B20,Sicilian Defense
1815,1893,58,resign,black,78,B50,Sicilian Defense
1812,1872,66,resign,black,60,B50,Sicilian Defense
1985,1993,42,resign,black,8,B50,Sicilian Defense
1802,1913,34,mate,black,111,B50,Sicilian Defense
1315,1189,70,mate,black,126,B20,Sicilian Defense
1526,1542,50,mate,black,16,B20,Sicilian Defense
1500,1374,64,mate,black,126,B50,Sicilian Defense
1333,1364,62,mate,black,31,B20,Sicilian Defense
1152,1246,28,mate,black,94,B20,Sicilian Defense
1451,1414,127,resign,black,37,B50,Sicilian Defense
2176,2027,122,resign,black,149,B20,Sicilian Defense
1267,1552,38,resign,black,285,B50,Sicilian Defense
1455,1442,74,resign,black,13,B20,Sicilian Defense
1645,1679,4,resign,black,34,B50,Sicilian Defense
1500,1758,34,resign,black,258,B50,Sicilian Defense
1457,1567,38,resign,black,110,B20,Sicilian Defense
1573,1678,46,resign,black,105,B20,Sicilian Defense
1589,1928,100,mate,black,339,B50,Sicilian Defense
2181,2153,82,resign,black,28,B50,Sicilian Defense
1683,1640,34,resign,black,43,B50,Sicilian Defense
1322,1557,72,mate,black,235,B50,Sicilian Defense
1381,1651,2,time,black,270,B20,Sicilian Defense
1868,1884,104,resign,black,16,B50,Sicilian Defense
1220,1281,58,resign,black,61,B20,Sicilian Defense
1226,1287,36,resign,black,61,B20,Sicilian Defense
1564,1621,62,resign,black,57,B50,Sicilian Defense
1385,1531,34,mate,black,146,B20,Sicilian Defense
1253,1539,20,resign,black,286,B20,Sicilian Defense
1764,1590,88,mate,black,174,B50,Sicilian Defense
1804,1938,30,resign,black,134,B20,Sicilian Defense
1758,1530,58,mate,black,228,B50,Sicilian Defense
1555,1570,70,resign,black,15,B54,Sicilian Defense
1316,1572,80,resign,black,256,B20,Sicilian Defense
1431,1735,58,resign,black,304,B50,Sicilian Defense
1228,1305,54,resign,black,77,B20,Sicilian Defense
1204,1447,40,resign,black,243,B20,Sicilian Defense
1211,1541,73,resign,black,330,B20,Sicilian Defense
1215,1546,85,resign,black,331,B20,Sicilian Defense
1223,1681,38,mate,black,458,B20,Sicilian Defense
1412,1492,34,resign,black,80,B50,Sicilian Defense
1417,1417,38,mate,black,0,B20,Sicilian Defense
1465,1910,74,resign,black,445,B20,Sicilian Defense
1891,1500,26,resign,black,391,B50,Sicilian Defense
2017,2232,118,mate,black,215,B20,Sicilian Defense
1303,1319,62,resign,black,16,B20,Sicilian Defense
1750,2195,56,resign,black,445,B20,Sicilian Defense
1411,1422,57,resign,black,11,B20,Sicilian Defense
1807,1769,122,mate,black,38,B20,Sicilian Defense
1239,1372,64,mate,black,133,B50,Sicilian Defense
1629,1410,120,mate,black,219,B50,Sicilian Defense
1256,1395,62,mate,black,139,B50,Sicilian Defense
1269,1421,79,resign,black,152,B54,Sicilian Defense
1417,1417,62,resign,black,0,B20,Sicilian Defense
1319,1395,84,mate,black,76,B20,Sicilian Defense
1329,1206,16,resign,black,123,B20,Sicilian Defense
1546,1621,42,resign,black,75,B54,Sicilian Defense #2
1835,1868,48,resign,black,33,B54,Sicilian Defense #2
1805,1800,106,resign,black,5,B54,Sicilian Defense #2
1854,1880,39,resign,black,26,B54,Sicilian Defense #2
1348,1725,52,resign,black,377,B54,Sicilian Defense #2
1559,1514,61,resign,black,45,B54,Sicilian Defense #2
1847,1895,104,time,black,48,B54,Sicilian Defense #2
1602,1611,100,resign,black,9,B54,Sicilian Defense #2
1712,1757,56,mate,black,45,B54,Sicilian Defense #2
1263,1587,56,mate,black,324,B34,Sicilian Defense: Accelerated Dragon
1443,1415,48,mate,black,28,B34,Sicilian Defense: Accelerated Dragon
1543,1210,124,time,black,333,B36,Sicilian Defense: Accelerated Dragon
1468,1468,58,resign,black,0,B34,Sicilian Defense: Accelerated Dragon |  Exchange Variation
1551,1538,104,mate,black,13,B34,Sicilian Defense: Accelerated Dragon |  Exchange Variation
1713,1709,70,resign,black,4,B38,Sicilian Defense: Accelerated Dragon |  Maroczy Bind
1861,1873,30,resign,black,12,B38,Sicilian Defense: Accelerated Dragon |  Maroczy Bind
1865,2076,26,resign,black,211,B35,Sicilian Defense: Accelerated Dragon |  Modern Bc4 Variation
2010,2327,22,resign,black,317,B35,Sicilian Defense: Accelerated Dragon |  Modern Bc4 Variation
1858,1944,126,time,black,86,B34,Sicilian Defense: Accelerated Dragon |  Modern Variation
1831,2120,56,time,black,289,B34,Sicilian Defense: Accelerated Dragon |  Modern Variation
1629,2082,22,resign,black,453,B34,Sicilian Defense: Accelerated Dragon |  Modern Variation
1840,1837,100,time,black,3,B22,Sicilian Defense: Alapin Variation
1843,1836,178,mate,black,7,B22,Sicilian Defense: Alapin Variation
1725,1896,30,resign,black,171,B22,Sicilian Defense: Alapin Variation
1629,1749,84,mate,black,120,B22,Sicilian Defense: Alapin Variation
1950,1920,66,mate,black,30,B22,Sicilian Defense: Alapin Variation
1400,1451,58,mate,black,51,B22,Sicilian Defense: Alapin Variation
1525,1418,76,mate,black,107,B22,Sicilian Defense: Alapin Variation
1464,1416,30,mate,black,48,B22,Sicilian Defense: Alapin Variation
1907,1860,56,resign,black,47,B22,Sicilian Defense: Alapin Variation
1574,2093,88,mate,black,519,B22,Sicilian Defense: Alapin Variation
1473,1381,54,mate,black,92,B22,Sicilian Defense: Alapin Variation
1381,1460,100,mate,black,79,B22,Sicilian Defense: Alapin Variation
1547,1625,89,resign,black,78,B22,Sicilian Defense: Alapin Variation
2209,2044,96,resign,black,165,B22,Sicilian Defense: Alapin Variation
1524,2195,126,time,black,671,B22,Sicilian Defense: Alapin Variation
1976,2135,39,resign,black,159,B22,Sicilian Defense: Alapin Variation |  Barmen Defense
2052,1992,50,resign,black,60,B22,Sicilian Defense: Alapin Variation |  Barmen Defense |  Central Exchange
2422,2386,58,resign,black,36,B22,Sicilian Defense: Alapin Variation |  Smith-Morra Declined
1909,2271,48,resign,black,362,B22,Sicilian Defense: Alapin Variation |  Smith-Morra Declined
1540,1540,62,mate,black,0,B20,Sicilian Defense: Bowdler Attack
1560,1892,52,resign,black,332,B20,Sicilian Defense: Bowdler Attack
1804,1931,78,mate,black,127,B20,Sicilian Defense: Bowdler Attack
1327,1420,30,mate,black,93,B20,Sicilian Defense: Bowdler Attack
1827,1933,76,mate,black,106,B20,Sicilian Defense: Bowdler Attack
1329,1466,27,resign,black,137,B20,Sicilian Defense: Bowdler Attack
1299,1647,64,mate,black,348,B20,Sicilian Defense: Bowdler Attack
1711,1751,66,resign,black,40,B20,Sicilian Defense: Bowdler Attack
1844,1857,142,resign,black,13,B20,Sicilian Defense: Bowdler Attack
1401,1382,44,mate,black,19,B20,Sicilian Defense: Bowdler Attack
1885,2261,74,resign,black,376,B20,Sicilian Defense: Bowdler Attack
1091,1203,6,resign,black,112,B20,Sicilian Defense: Bowdler Attack
1470,1428,42,resign,black,42,B20,Sicilian Defense: Bowdler Attack
950,1274,18,resign,black,324,B20,Sicilian Defense: Bowdler Attack
1268,1204,32,mate,black,64,B20,Sicilian Defense: Bowdler Attack
1459,1461,93,resign,black,2,B20,Sicilian Defense: Bowdler Attack
1565,1831,136,resign,black,266,B20,Sicilian Defense: Bowdler Attack
1581,1767,42,resign,black,186,B20,Sicilian Defense: Bowdler Attack
1679,1652,112,resign,black,27,B20,Sicilian Defense: Bowdler Attack
1632,1727,28,mate,black,95,B20,Sicilian Defense: Bowdler Attack
1646,1553,48,resign,black,93,B20,Sicilian Defense: Bowdler Attack
1497,1491,132,resign,black,6,B20,Sicilian Defense: Bowdler Attack
1430,1482,42,mate,black,52,B20,Sicilian Defense: Bowdler Attack
1440,1451,57,resign,black,11,B20,Sicilian Defense: Bowdler Attack
1157,2312,8,resign,black,1155,B20,Sicilian Defense: Bowdler Attack
1641,1726,48,mate,black,85,B20,Sicilian Defense: Bowdler Attack
1049,1539,22,resign,black,490,B20,Sicilian Defense: Bowdler Attack
1351,1498,94,resign,black,147,B20,Sicilian Defense: Bowdler Attack
1363,1448,68,resign,black,85,B20,Sicilian Defense: Bowdler Attack
1252,1498,20,mate,black,246,B20,Sicilian Defense: Bowdler Attack
1651,1690,10,resign,black,39,B20,Sicilian Defense: Bowdler Attack
1598,1703,36,resign,black,105,B20,Sicilian Defense: Bowdler Attack
1974,2243,52,mate,black,269,B20,Sicilian Defense: Bowdler Attack
1460,1514,174,mate,black,54,B20,Sicilian Defense: Bowdler Attack
1504,1578,66,mate,black,74,B20,Sicilian Defense: Bowdler Attack
1564,1578,58,resign,black,14,B20,Sicilian Defense: Bowdler Attack
1604,1869,144,time,black,265,B20,Sicilian Defense: Bowdler Attack
1458,1524,32,resign,black,66,B20,Sicilian Defense: Bowdler Attack
1520,1524,79,resign,black,4,B20,Sicilian Defense: Bowdler Attack
1524,1567,86,time,black,43,B20,Sicilian Defense: Bowdler Attack
1341,1409,44,mate,black,68,B20,Sicilian Defense: Bowdler Attack
1364,1373,130,resign,black,9,B20,Sicilian Defense: Bowdler Attack
1498,1533,32,resign,black,35,B20,Sicilian Defense: Bowdler Attack
1519,1671,40,resign,black,152,B20,Sicilian Defense: Bowdler Attack
1500,1543,12,resign,black,43,B20,Sicilian Defense: Bowdler Attack
1616,1826,126,mate,black,210,B20,Sicilian Defense: Bowdler Attack
1627,1814,72,mate,black,187,B20,Sicilian Defense: Bowdler Attack
1516,1860,60,mate,black,344,B20,Sicilian Defense: Bowdler Attack
1522,1865,142,time,black,343,B20,Sicilian Defense: Bowdler Attack
1712,1563,92,time,black,149,B20,Sicilian Defense: Bowdler Attack
1417,1386,46,mate,black,31,B20,Sicilian Defense: Bowdler Attack
1541,1817,64,mate,black,276,B20,Sicilian Defense: Bowdler Attack
1528,1192,32,mate,black,336,B20,Sicilian Defense: Bowdler Attack
1689,2201,114,resign,black,512,B20,Sicilian Defense: Bowdler Attack
1200,1002,64,mate,black,198,B52,Sicilian Defense: Canal Attack |  Main Line
1879,2326,84,mate,black,447,B52,Sicilian Defense: Canal Attack |  Main Line
1435,1543,61,resign,black,108,B52,Sicilian Defense: Canal Attack |  Main Line
1265,1366,144,mate,black,101,B52,Sicilian Defense: Canal Attack |  Main Line
1485,1403,50,mate,black,82,B52,Sicilian Defense: Canal Attack |  Main Line
1457,1418,20,resign,black,39,B52,Sicilian Defense: Canal Attack |  Main Line
1475,1560,38,mate,black,85,B51,Sicilian Defense: Canal-Sokolsky Attack
1703,1916,66,resign,black,213,B51,Sicilian Defense: Canal-Sokolsky Attack
1397,1407,16,resign,black,10,B51,Sicilian Defense: Canal-Sokolsky Attack
1383,1360,88,mate,black,23,B51,Sicilian Defense: Canal-Sokolsky Attack
1698,1564,44,resign,black,134,B53,Sicilian Defense: Chekhover Variation
1621,1650,86,time,black,29,B56,Sicilian Defense: Classical Variation
1576,1931,82,resign,black,355,B56,Sicilian Defense: Classical Variation
1741,1743,66,mate,black,2,B23,Sicilian Defense: Closed
1412,1398,60,resign,black,14,B23,Sicilian Defense: Closed
1954,2158,34,resign,black,204,B23,Sicilian Defense: Closed Variation
1515,1319,106,resign,black,196,B23,Sicilian Defense: Closed Variation
1585,1697,80,time,black,112,B23,Sicilian Defense: Closed Variation
1839,1871,100,mate,black,32,B23,Sicilian Defense: Closed Variation
1372,1440,64,resign,black,68,B23,Sicilian Defense: Closed Variation
1135,1129,84,mate,black,6,B23,Sicilian Defense: Closed Variation
1300,1319,112,mate,black,19,B23,Sicilian Defense: Closed Variation
1279,1696,26,resign,black,417,B23,Sicilian Defense: Closed Variation
1137,1533,51,resign,black,396,B23,Sicilian Defense: Closed Variation
1645,1748,46,mate,black,103,B23,Sicilian Defense: Closed Variation
1801,1778,62,resign,black,23,B23,Sicilian Defense: Closed Variation
1506,1978,62,mate,black,472,B23,Sicilian Defense: Closed Variation
1594,1225,56,mate,black,369,B23,Sicilian Defense: Closed Variation
1331,1289,70,resign,black,42,B23,Sicilian Defense: Closed Variation |  Chameleon Variation
2239,2321,52,resign,black,82,B23,Sicilian Defense: Closed Variation |  Korchnoi Defense
1345,1392,96,resign,black,47,B25,Sicilian Defense: Closed Variation |  Traditional
1476,1453,70,resign,black,23,B25,Sicilian Defense: Closed Variation |  Traditional
1644,1810,30,resign,black,166,B25,Sicilian Defense: Closed Variation |  Traditional
2324,2349,55,resign,black,25,B25,Sicilian Defense: Closed Variation |  Traditional
1265,1267,132,resign,black,2,B25,Sicilian Defense: Closed Variation |  Traditional
998,1299,41,resign,black,301,B25,Sicilian Defense: Closed Variation |  Traditional
1160,2001,56,mate,black,841,B25,Sicilian Defense: Closed Variation |  Traditional
1734,2007,60,resign,black,273,B25,Sicilian Defense: Closed Variation |  Traditional
1537,1662,104,mate,black,125,B25,Sicilian Defense: Closed Variation |  Traditional
1860,1840,70,resign,black,20,B50,Sicilian Defense: Delayed Alapin
1795,1789,84,resign,black,6,B50,Sicilian Defense: Delayed Alapin
1796,1875,92,time,black,79,B50,Sicilian Defense: Delayed Alapin
2151,2209,190,mate,black,58,B50,Sicilian Defense: Delayed Alapin
2225,2207,114,mate,black,18,B50,Sicilian Defense: Delayed Alapin
1734,1384,40,resign,black,350,B50,Sicilian Defense: Delayed Alapin
1738,1717,56,resign,black,21,B50,Sicilian Defense: Delayed Alapin
1923,1974,44,resign,black,51,B50,Sicilian Defense: Delayed Alapin
2052,2028,76,resign,black,24,B50,Sicilian Defense: Delayed Alapin
857,1057,86,mate,black,200,B40,Sicilian Defense: Delayed Alapin Variation
1883,1961,68,resign,black,78,B40,Sicilian Defense: Delayed Alapin Variation
1947,1929,102,time,black,18,B40,Sicilian Defense: Delayed Alapin Variation
1517,1519,30,mate,black,2,B28,Sicilian Defense: Double-Dutch Gambit
1280,1214,50,resign,black,66,B70,Sicilian Defense: Dragon Variation
2200,2015,44,mate,black,185,B72,Sicilian Defense: Dragon Variation |  Classical Variation #2
1527,1611,72,resign,black,84,B72,Sicilian Defense: Dragon Variation |  Classical Variation #2
2231,2230,90,resign,black,1,B72,Sicilian Defense: Dragon Variation |  Classical Variation #2
2239,2241,164,mate,black,2,B76,Sicilian Defense: Dragon Variation |  Yugoslav Attack |  Modern Line
1579,1557,94,time,black,22,B72,Sicilian Defense: Dragon |  6.Be3
1406,1458,60,mate,black,52,B40,Sicilian Defense: Drazic Variation
1649,2183,42,resign,black,534,B32,Sicilian Defense: Flohr Variation
1703,2021,51,resign,black,318,B32,Sicilian Defense: Flohr Variation
1813,1528,40,resign,black,285,B45,Sicilian Defense: Four Knights Variation |  Exchange Variation
1848,1806,80,resign,black,42,B40,Sicilian Defense: French Variation
1373,2148,31,resign,black,775,B40,Sicilian Defense: French Variation
1807,2008,94,time,black,201,B40,Sicilian Defense: French Variation
1749,1977,52,resign,black,228,B40,Sicilian Defense: French Variation
1784,1897,72,mate,black,113,B40,Sicilian Defense: French Variation
1369,1408,64,mate,black,39,B40,Sicilian Defense: French Variation
1332,2043,24,resign,black,711,B40,Sicilian Defense: French Variation
1352,2041,48,mate,black,689,B40,Sicilian Defense: French Variation
1964,2169,60,mate,black,205,B40,Sicilian Defense: French Variation
1717,1709,66,time,black,8,B40,Sicilian Defense: French Variation
1486,1688,94,time,black,202,B40,Sicilian Defense: French Variation
1728,1723,18,resign,black,5,B40,Sicilian Defense: French Variation |  Normal
1781,1971,62,resign,black,190,B40,Sicilian Defense: French Variation |  Normal
1537,1453,74,mate,black,84,B40,Sicilian Defense: French Variation |  Normal
1571,1725,39,resign,black,154,B40,Sicilian Defense: French Variation |  Open
1331,1347,33,resign,black,16,B32,Sicilian Defense: Godiva Variation
1748,1855,62,resign,black,107,B32,Sicilian Defense: Godiva Variation
1410,1882,14,resign,black,472,B27,Sicilian Defense: Hyperaccelerated Dragon
1293,1710,30,resign,black,417,B27,Sicilian Defense: Hyperaccelerated Dragon
1287,1611,90,mate,black,324,B27,Sicilian Defense: Hyperaccelerated Dragon
1789,1607,30,resign,black,182,B27,Sicilian Defense: Hyperaccelerated Dragon
1892,1825,56,resign,black,67,A42,Sicilian Defense: Hyperaccelerated Fianchetto
2007,2184,75,resign,black,177,A42,Sicilian Defense: Hyperaccelerated Fianchetto
1525,1633,49,resign,black,108,B27,Sicilian Defense: Hyperaccelerated Pterodactyl
1274,1534,44,mate,black,260,B27,Sicilian Defense: Jalalabad Variation
1283,1499,58,mate,black,216,B27,Sicilian Defense: Jalalabad Variation
1895,1977,154,time,black,82,B32,Sicilian Defense: Kalashnikov Variation
1841,1940,47,resign,black,99,B32,Sicilian Defense: Kalashnikov Variation
1953,1986,66,mate,black,33,B32,Sicilian Defense: Kalashnikov Variation
1774,2071,100,resign,black,297,B41,Sicilian Defense: Kan Variation
1500,1762,44,resign,black,262,B41,Sicilian Defense: Kan Variation
1848,2122,52,resign,black,274,B41,Sicilian Defense: Kan Variation
1744,1801,74,resign,black,57,B43,Sicilian Defense: Kan Variation |  Knight Variation
1366,2301,94,resign,black,935,B43,Sicilian Defense: Kan Variation |  Knight Variation
1578,1603,36,resign,black,25,B43,Sicilian Defense: Kan Variation |  Knight Variation
1439,1390,51,resign,black,49,B43,Sicilian Defense: Kan Variation |  Knight Variation
1887,2187,38,resign,black,300,B43,Sicilian Defense: Kan Variation |  Knight Variation
1384,1285,48,resign,black,99,B42,Sicilian Defense: Kan Variation |  Modern Variation
2014,2171,50,resign,black,157,B42,Sicilian Defense: Kan Variation |  Modern Variation
1688,1743,38,resign,black,55,B43,Sicilian Defense: Kan Variation |  Wing Attack
1933,2318,48,mate,black,385,B43,Sicilian Defense: Kan Variation |  Wing Attack
2191,2239,72,resign,black,48,B43,Sicilian Defense: Kan Variation |  Wing Attack
2336,2185,72,mate,black,151,B43,Sicilian Defense: Kan Variation |  Wing Attack
1690,2172,47,resign,black,482,B43,Sicilian Defense: Kan Variation |  Wing Attack
1387,1296,78,mate,black,91,B27,Sicilian Defense: Katalimov Variation
1662,1584,74,time,black,78,B27,Sicilian Defense: Katalimov Variation
1876,1906,84,resign,black,30,B40,Sicilian Defense: Kramnik Variation
1361,1555,31,resign,black,194,B40,Sicilian Defense: Kramnik Variation
1505,1851,58,resign,black,346,B20,Sicilian Defense: Lasker-Dunne Attack
1848,2098,78,resign,black,250,B33,Sicilian Defense: Lasker-Pelikan Variation
1879,2230,56,mate,black,351,B33,Sicilian Defense: Lasker-Pelikan Variation |  Exchange Variation
1788,2029,100,mate,black,241,B33,Sicilian Defense: Lasker-Pelikan Variation |  Exchange Variation
1978,2245,84,resign,black,267,B33,Sicilian Defense: Lasker-Pelikan Variation |  Schlechter Variation
1626,1536,36,mate,black,90,B33,Sicilian Defense: Lasker-Pelikan Variation |  Schlechter Variation
2373,2356,50,resign,black,17,B33,Sicilian Defense: Lasker-Pelikan Variation |  Sveshnikov Variation |  Chelyabinsk Variation
1689,1670,42,mate,black,19,B32,Sicilian Defense: Loewenthal Variation
1152,1158,104,resign,black,6,B32,Sicilian Defense: Loewenthal Variation
1286,1972,60,resign,black,686,B32,Sicilian Defense: Loewenthal Variation
1499,1995,56,resign,black,496,B32,Sicilian Defense: Loewenthal Variation
1371,1326,56,resign,black,45,B32,Sicilian Defense: Loewenthal Variation
1698,1977,25,resign,black,279,B32,Sicilian Defense: Loewenthal Variation
1300,1397,44,resign,black,97,B40,Sicilian Defense: Marshall Counterattack
1689,1668,86,resign,black,21,B21,Sicilian Defense: McDonnell Attack
1450,1452,54,time,black,2,B21,Sicilian Defense: McDonnell Attack
1322,1507,22,mate,black,185,B21,Sicilian Defense: McDonnell Attack
1423,1645,40,resign,black,222,B21,Sicilian Defense: McDonnell Attack
1975,2015,71,resign,black,40,B21,Sicilian Defense: McDonnell Attack
1974,1990,60,resign,black,16,B21,Sicilian Defense: McDonnell Attack
1786,1900,40,resign,black,114,B21,Sicilian Defense: McDonnell Attack
1520,1565,40,mate,black,45,B21,Sicilian Defense: McDonnell Attack
1587,1500,34,mate,black,87,B21,Sicilian Defense: McDonnell Attack
1207,1422,55,resign,black,215,B21,Sicilian Defense: McDonnell Attack
1193,1594,26,resign,black,401,B50,Sicilian Defense: Modern Variations |  Anti-Qxd4 Move Order
1675,2008,30,mate,black,333,B57,Sicilian Defense: Modern Variations |  Main Line
1417,1454,63,resign,black,37,B57,Sicilian Defense: Modern Variations |  Main Line
1750,1733,98,mate,black,17,B57,Sicilian Defense: Modern Variations |  Main Line
1208,1421,56,mate,black,213,B57,Sicilian Defense: Modern Variations |  Main Line
1517,1346,54,mate,black,171,B20,Sicilian Defense: Myers Attack
1647,1635,64,resign,black,12,B96,Sicilian Defense: Najdorf Variation
1780,2132,40,resign,black,352,B90,Sicilian Defense: Najdorf Variation
1783,2045,49,resign,black,262,B90,Sicilian Defense: Najdorf Variation
1695,1923,80,resign,black,228,B94,Sicilian Defense: Najdorf Variation
1892,2018,48,mate,black,126,B95,Sicilian Defense: Najdorf Variation
1901,1893,148,time,black,8,B90,Sicilian Defense: Najdorf Variation
1466,1815,96,resign,black,349,B90,Sicilian Defense: Najdorf Variation
1828,1715,74,resign,black,113,B94,Sicilian Defense: Najdorf Variation
1566,1536,90,resign,black,30,B90,Sicilian Defense: Najdorf Variation
1372,1953,156,resign,black,581,B90,Sicilian Defense: Najdorf Variation
1759,1500,94,mate,black,259,B90,Sicilian Defense: Najdorf Variation
1517,2061,50,mate,black,544,B90,Sicilian Defense: Najdorf Variation
1651,2068,90,mate,black,417,B96,Sicilian Defense: Najdorf Variation
2230,1948,86,time,black,282,B90,Sicilian Defense: Najdorf Variation
1345,1452,25,resign,black,107,B93,Sicilian Defense: Najdorf Variation |  Amsterdam Variation
1630,1723,86,mate,black,93,B90,Sicilian Defense: Najdorf Variation |  English Attack
1484,1558,74,time,black,74,B92,Sicilian Defense: Najdorf Variation |  Opocensky Variation
1939,2008,84,resign,black,69,B92,Sicilian Defense: Najdorf Variation |  Opocensky Variation
1508,2364,30,resign,black,856,B90,Sicilian Defense: Najdorf |  Lipnitsky Attack
1720,1943,50,resign,black,223,B90,Sicilian Defense: Najdorf |  Lipnitsky Attack
1810,1974,78,resign,black,164,B90,Sicilian Defense: Najdorf |  Lipnitsky Attack
1799,1760,116,resign,black,39,B90,Sicilian Defense: Najdorf |  Lipnitsky Attack
1497,1514,62,mate,black,17,B90,Sicilian Defense: Najdorf |  Lipnitsky Attack
2055,2179,50,resign,black,124,B90,Sicilian Defense: Najdorf |  Lipnitsky Attack
1210,1280,66,mate,black,70,B29,Sicilian Defense: Nimzowitsch Variation
1277,1490,80,mate,black,213,B29,Sicilian Defense: Nimzowitsch Variation |  Advance Variation
1621,1496,50,mate,black,125,B30,Sicilian Defense: Nyezhmetdinov-Rossolimo Attack
1173,1251,26,resign,black,78,B30,Sicilian Defense: Nyezhmetdinov-Rossolimo Attack
1368,1635,36,resign,black,267,B30,Sicilian Defense: Nyezhmetdinov-Rossolimo Attack
1772,1770,78,resign,black,2,B30,Sicilian Defense: Nyezhmetdinov-Rossolimo Attack
1521,1526,142,mate,black,5,B30,Sicilian Defense: Nyezhmetdinov-Rossolimo Attack
1201,1389,33,resign,black,188,B30,Sicilian Defense: Nyezhmetdinov-Rossolimo Attack
2276,1949,184,mate,black,327,B30,Sicilian Defense: Nyezhmetdinov-Rossolimo Attack
1708,1726,152,mate,black,18,B30,Sicilian Defense: Nyezhmetdinov-Rossolimo Attack
1862,1827,10,resign,black,35,B30,Sicilian Defense: Nyezhmetdinov-Rossolimo Attack
1432,1700,84,resign,black,268,B30,Sicilian Defense: Nyezhmetdinov-Rossolimo Attack
1905,1898,106,resign,black,7,B30,Sicilian Defense: Nyezhmetdinov-Rossolimo Attack
1907,1886,66,resign,black,21,B30,Sicilian Defense: Nyezhmetdinov-Rossolimo Attack
1866,1965,50,resign,black,99,B31,Sicilian Defense: Nyezhmetdinov-Rossolimo Attack |  Fianchetto Variation
1737,1775,62,time,black,38,B31,Sicilian Defense: Nyezhmetdinov-Rossolimo Attack |  Fianchetto Variation
1416,1699,60,resign,black,283,B28,Sicilian Defense: O'Kelly Variation
1351,1726,26,resign,black,375,B28,Sicilian Defense: O'Kelly Variation
1413,1430,65,resign,black,17,B28,Sicilian Defense: O'Kelly Variation
1977,2241,80,resign,black,264,B28,Sicilian Defense: O'Kelly Variation |  Maroczy Bind |  Paulsen Line
1867,1785,100,mate,black,82,B28,Sicilian Defense: O'Kelly Variation |  Normal System |  Taimanov Line
1831,1796,46,resign,black,35,B28,Sicilian Defense: O'Kelly Variation |  Reti System
1283,1393,40,resign,black,110,B28,Sicilian Defense: O'Kelly Variation |  Venice System |  Ljubojevic Line
1834,1835,40,resign,black,1,B30,Sicilian Defense: Old Sicilian
1871,1847,54,resign,black,24,B30,Sicilian Defense: Old Sicilian
1380,1429,20,resign,black,49,B30,Sicilian Defense: Old Sicilian
1918,2086,66,resign,black,168,B30,Sicilian Defense: Old Sicilian
1479,1381,56,resign,black,98,B30,Sicilian Defense: Old Sicilian
1372,1360,66,resign,black,12,B30,Sicilian Defense: Old Sicilian
1706,1698,31,resign,black,8,B30,Sicilian Defense: Old Sicilian
1648,1719,72,mate,black,71,B30,Sicilian Defense: Old Sicilian
1730,1882,16,resign,black,152,B30,Sicilian Defense: Old Sicilian
1655,1668,90,resign,black,13,B30,Sicilian Defense: Old Sicilian
1693,1693,148,mate,black,0,B30,Sicilian Defense: Old Sicilian
1865,1990,44,resign,black,125,B30,Sicilian Defense: Old Sicilian
1844,1839,80,resign,black,5,B30,Sicilian Defense: Old Sicilian
1383,1352,56,resign,black,31,B30,Sicilian Defense: Old Sicilian
1406,1321,50,resign,black,85,B30,Sicilian Defense: Old Sicilian
1407,1461,27,resign,black,54,B30,Sicilian Defense: Old Sicilian
1296,1702,64,resign,black,406,B30,Sicilian Defense: Old Sicilian
1972,1919,92,resign,black,53,B30,Sicilian Defense: Old Sicilian
1657,1638,46,resign,black,19,B30,Sicilian Defense: Old Sicilian
1645,1737,154,mate,black,92,B30,Sicilian Defense: Old Sicilian
1626,1503,48,resign,black,123,B30,Sicilian Defense: Old Sicilian
1500,2113,6,resign,black,613,B30,Sicilian Defense: Old Sicilian
1680,1799,53,resign,black,119,B30,Sicilian Defense: Old Sicilian
1576,1719,64,resign,black,143,B30,Sicilian Defense: Old Sicilian
1575,1869,36,resign,black,294,B30,Sicilian Defense: Old Sicilian
1521,1443,35,resign,black,78,B30,Sicilian Defense: Old Sicilian
1528,1603,56,mate,black,75,B30,Sicilian Defense: Old Sicilian
1539,1654,60,resign,black,115,B30,Sicilian Defense: Old Sicilian
1485,1470,72,mate,black,15,B30,Sicilian Defense: Old Sicilian
1497,1437,58,resign,black,60,B30,Sicilian Defense: Old Sicilian
1895,1919,72,resign,black,24,B30,Sicilian Defense: Old Sicilian
1838,1962,30,resign,black,124,B30,Sicilian Defense: Old Sicilian
1268,1528,48,mate,black,260,B30,Sicilian Defense: Old Sicilian
1537,1532,70,resign,black,5,B30,Sicilian Defense: Old Sicilian
1509,1859,84,resign,black,350,B30,Sicilian Defense: Old Sicilian
1712,1848,74,resign,black,136,B30,Sicilian Defense: Old Sicilian
1692,1735,136,resign,black,43,B30,Sicilian Defense: Old Sicilian
1688,1995,80,resign,black,307,B30,Sicilian Defense: Old Sicilian
1663,1924,42,resign,black,261,B30,Sicilian Defense: Old Sicilian
1891,1912,98,resign,black,21,B30,Sicilian Defense: Old Sicilian
1982,2042,57,resign,black,60,B30,Sicilian Defense: Old Sicilian
1778,2059,10,resign,black,281,B33,Sicilian Defense: Open
1765,1577,46,resign,black,188,B33,Sicilian Defense: Open
1292,1330,66,resign,black,38,B32,Sicilian Defense: Open
1222,1732,88,time,black,510,B32,Sicilian Defense: Open #3
1724,1734,28,resign,black,10,B32,Sicilian Defense: Open #3
1844,1713,154,time,black,131,B32,Sicilian Defense: Open #3
1847,1891,54,mate,black,44,B32,Sicilian Defense: Open #3
1683,1621,140,resign,black,62,B46,Sicilian Defense: Paulsen Variation
1661,1618,54,mate,black,43,B44,Sicilian Defense: Paulsen Variation
1593,1608,72,resign,black,15,B46,Sicilian Defense: Paulsen Variation
1555,1730,55,resign,black,175,B46,Sicilian Defense: Paulsen Variation
1780,1671,90,resign,black,109,B44,Sicilian Defense: Paulsen Variation
1524,1686,46,mate,black,162,B44,Sicilian Defense: Paulsen Variation
1380,1457,66,resign,black,77,B44,Sicilian Defense: Paulsen Variation
1276,1675,24,resign,black,399,B46,Sicilian Defense: Paulsen Variation
1522,1518,56,mate,black,4,B46,Sicilian Defense: Paulsen Variation
1786,1817,33,resign,black,31,B46,Sicilian Defense: Paulsen Variation
1801,1749,20,mate,black,52,B44,Sicilian Defense: Paulsen Variation
1333,1876,76,mate,black,543,B45,Sicilian Defense: Paulsen Variation |  Normal Variation
1570,1578,36,mate,black,8,B40,Sicilian Defense: Paulsen-Basman Defense
2179,1991,90,resign,black,188,B40,Sicilian Defense: Pin Variation
1465,1438,50,resign,black,27,B84,Sicilian Defense: Scheveningen Variation |  Classical Variation #2
1364,1657,92,resign,black,293,B21,Sicilian Defense: Smith-Morra Gambit
1883,1939,62,mate,black,56,B21,Sicilian Defense: Smith-Morra Gambit
1113,1423,13,resign,black,310,B21,Sicilian Defense: Smith-Morra Gambit #2
1358,1036,64,resign,black,322,B21,Sicilian Defense: Smith-Morra Gambit #2
1701,2100,44,mate,black,399,B21,Sicilian Defense: Smith-Morra Gambit #2
1602,1791,76,resign,black,189,B21,Sicilian Defense: Smith-Morra Gambit #2
1415,1788,68,time,black,373,B21,Sicilian Defense: Smith-Morra Gambit #2
1369,1553,88,mate,black,184,B21,Sicilian Defense: Smith-Morra Gambit #2
1245,1264,92,mate,black,19,B21,Sicilian Defense: Smith-Morra Gambit #2
1251,1177,78,mate,black,74,B21,Sicilian Defense: Smith-Morra Gambit #2
1283,1668,19,resign,black,385,B21,Sicilian Defense: Smith-Morra Gambit #2
1213,1519,74,time,black,306,B21,Sicilian Defense: Smith-Morra Gambit #2
1410,1736,138,time,black,326,B21,Sicilian Defense: Smith-Morra Gambit #2
1508,1440,32,resign,black,68,B21,Sicilian Defense: Smith-Morra Gambit #2
1406,1404,56,mate,black,2,B21,Sicilian Defense: Smith-Morra Gambit #2
1184,1223,120,mate,black,39,B21,Sicilian Defense: Smith-Morra Gambit #2
1303,1471,70,resign,black,168,B21,Sicilian Defense: Smith-Morra Gambit #2
1290,1760,45,resign,black,470,B21,Sicilian Defense: Smith-Morra Gambit #2
1857,2247,86,mate,black,390,B21,Sicilian Defense: Smith-Morra Gambit #2
1834,2181,27,resign,black,347,B21,Sicilian Defense: Smith-Morra Gambit #2
1527,1558,70,resign,black,31,B21,Sicilian Defense: Smith-Morra Gambit #2
1864,1398,71,resign,black,466,B21,Sicilian Defense: Smith-Morra Gambit #2
1432,1895,62,mate,black,463,B21,Sicilian Defense: Smith-Morra Gambit #2
1889,1837,74,mate,black,52,B21,Sicilian Defense: Smith-Morra Gambit #2
1401,1430,130,mate,black,29,B21,Sicilian Defense: Smith-Morra Gambit #2
1328,1607,88,resign,black,279,B21,Sicilian Defense: Smith-Morra Gambit #2
1242,1402,22,time,black,160,B21,Sicilian Defense: Smith-Morra Gambit #2
1611,1775,48,mate,black,164,B21,Sicilian Defense: Smith-Morra Gambit #2
2048,2184,62,resign,black,136,B21,Sicilian Defense: Smith-Morra Gambit Accepted |  Pin Defense
1853,1912,92,resign,black,59,B21,Sicilian Defense: Smith-Morra Gambit Accepted |  Scheveningen Formation
1524,1269,74,resign,black,255,B20,Sicilian Defense: Snyder Variation
1753,1672,34,resign,black,81,B20,Sicilian Defense: Snyder Variation
1614,2002,78,resign,black,388,B20,Sicilian Defense: Snyder Variation
1396,1507,14,resign,black,111,B20,Sicilian Defense: Snyder Variation
1799,1634,92,time,black,165,B20,Sicilian Defense: Snyder Variation
1507,1529,108,mate,black,22,B86,Sicilian Defense: Sozin Attack
1673,1678,32,resign,black,5,B86,Sicilian Defense: Sozin Attack
1832,1829,54,resign,black,3,B88,Sicilian Defense: Sozin Attack |  Leonhardt Variation
1932,1839,24,resign,black,93,B88,Sicilian Defense: Sozin Attack |  Leonhardt Variation
1465,1533,22,resign,black,68,B88,Sicilian Defense: Sozin Attack |  Leonhardt Variation
1613,1891,86,mate,black,278,B20,Sicilian Defense: Staunton-Cochrane Variation
2030,2164,56,mate,black,134,B20,Sicilian Defense: Staunton-Cochrane Variation
1252,1611,40,resign,black,359,B20,Sicilian Defense: Staunton-Cochrane Variation
1168,1833,55,resign,black,665,B20,Sicilian Defense: Staunton-Cochrane Variation
1173,1410,50,time,black,237,B20,Sicilian Defense: Staunton-Cochrane Variation
1450,1452,42,resign,black,2,B20,Sicilian Defense: Staunton-Cochrane Variation
1036,1035,76,time,black,1,B20,Sicilian Defense: Staunton-Cochrane Variation
1487,1663,82,time,black,176,B20,Sicilian Defense: Staunton-Cochrane Variation
1824,1992,58,mate,black,168,B20,Sicilian Defense: Staunton-Cochrane Variation
1902,2176,50,mate,black,274,B20,Sicilian Defense: Staunton-Cochrane Variation
1528,1530,64,mate,black,2,B20,Sicilian Defense: Staunton-Cochrane Variation
1453,1533,56,resign,black,80,B20,Sicilian Defense: Staunton-Cochrane Variation
1233,1215,29,resign,black,18,B20,Sicilian Defense: Staunton-Cochrane Variation
1800,1750,59,resign,black,50,B20,Sicilian Defense: Wing Gambit
1854,1799,29,resign,black,55,B20,Sicilian Defense: Wing Gambit
2073,2195,66,mate,black,122,B40,Sicilian Defense: Wing Gambit Deferred
2173,2287,50,resign,black,114,B20,Sicilian Defense: Wing Gambit |  Carlsbad Variation
2290,2317,68,resign,black,27,B20,Sicilian Defense: Wing Gambit |  Carlsbad Variation
2077,2443,84,resign,black,366,B20,Sicilian Defense: Wing Gambit |  Marshall Variation
2085,2436,28,resign,black,351,B20,Sicilian Defense: Wing Gambit |  Marshall Variation
2234,2352,50,mate,black,118,B20,Sicilian Defense: Wing Gambit |  Marshall Variation
1056,1156,53,resign,black,100,D10,Slav Defense
1453,1576,70,resign,black,123,D10,Slav Defense
1828,1694,94,time,black,134,D10,Slav Defense
1500,1584,46,time,black,84,D10,Slav Defense
1912,1867,106,time,black,45,D10,Slav Defense
1859,1798,40,resign,black,61,D10,Slav Defense
1494,1587,38,mate,black,93,D10,Slav Defense
1621,1566,60,resign,black,55,D10,Slav Defense
1991,1932,94,resign,black,59,D10,Slav Defense
1500,1487,64,resign,black,13,D10,Slav Defense #2
1922,1851,98,resign,black,71,D10,Slav Defense #2
1500,1901,54,mate,black,401,D10,Slav Defense #2
1716,1659,100,resign,black,57,D10,Slav Defense #2
1614,1732,74,mate,black,118,D10,Slav Defense #2
1676,2003,124,resign,black,327,D10,Slav Defense #2
1688,1716,62,resign,black,28,D10,Slav Defense #2
1678,1649,38,resign,black,29,D10,Slav Defense #2
1622,1531,116,mate,black,91,D10,Slav Defense #2
1244,1297,17,resign,black,53,D10,Slav Defense #3
1181,1310,54,mate,black,129,D10,Slav Defense #3
1826,1802,66,time,black,24,D10,Slav Defense #3
2033,1949,80,resign,black,84,D10,Slav Defense #3
1677,1635,120,mate,black,42,D15,Slav Defense: Alekhine Variation
1295,1240,42,resign,black,55,D11,Slav Defense: Bonet Gambit
1575,2291,76,resign,black,716,D15,Slav Defense: Chameleon Variation
1788,1757,42,resign,black,31,D17,Slav Defense: Czech Variation
1839,1651,86,resign,black,188,D10,Slav Defense: Exchange Variation
1148,1417,78,mate,black,269,D10,Slav Defense: Exchange Variation
1693,1559,54,mate,black,134,D12,Slav Defense: Exchange Variation |  Schallopp Variation
1922,1847,140,mate,black,75,D12,Slav Defense: Exchange Variation |  Schallopp Variation
1960,2260,64,resign,black,300,D11,Slav Defense: Modern Line
1647,1745,15,resign,black,98,D11,Slav Defense: Modern Line
1649,1608,29,resign,black,41,D11,Slav Defense: Modern Line
1625,1668,30,resign,black,43,D11,Slav Defense: Modern Line
1600,1636,62,mate,black,36,D11,Slav Defense: Modern Line
1086,1774,48,mate,black,688,D12,Slav Defense: Quiet Variation |  Pin Defense
1831,1872,40,mate,black,41,D12,Slav Defense: Quiet Variation |  Pin Defense
1658,1663,22,mate,black,5,D12,Slav Defense: Quiet Variation |  Schallopp Defense
1615,1965,54,mate,black,350,D12,Slav Defense: Quiet Variation |  Schallopp Defense
1580,1578,84,mate,black,2,D15,Slav Defense: Schlechter Variation
1159,1474,24,resign,black,315,D15,Slav Defense: Three Knights Variation
1630,1851,24,resign,black,221,D15,Slav Defense: Three Knights Variation
1698,1241,53,resign,black,457,D15,Slav Defense: Three Knights Variation
1547,1490,70,mate,black,57,D15,Slav Defense: Three Knights Variation
1791,1484,75,resign,black,307,D15,Slav Defense: Three Knights Variation
1675,1597,158,mate,black,78,D15,Slav Defense: Three Knights Variation
1838,1818,44,resign,black,20,D10,Slav Defense: Winawer Countergambit
1315,1346,136,resign,black,31,A50,Slav Indian
1462,1715,102,resign,black,253,A50,Slav Indian
1442,1310,30,mate,black,132,A00,Sodium Attack
1638,1606,56,resign,black,32,C00,St. George Defense
1277,1550,66,resign,black,273,B00,St. George Defense
1807,2172,62,mate,black,365,B00,St. George Defense
1071,1312,16,resign,black,241,B00,St. George Defense
1530,1568,64,time,black,38,B00,St. George Defense
1554,1456,83,resign,black,98,B00,St. George Defense
1749,1559,80,resign,black,190,B00,St. George Defense
1648,1792,80,resign,black,144,C00,St. George Defense
1531,1569,38,resign,black,38,B00,St. George Defense: Zilbermints Gambit
2208,2421,112,resign,black,213,A02,System: Double Duck Formation
1445,1627,82,resign,black,182,D32,Tarrasch Defense
1644,1264,36,mate,black,380,D32,Tarrasch Defense
1697,1794,140,resign,black,97,D34,Tarrasch Defense: Classical Variation
2136,2353,48,resign,black,217,D34,Tarrasch Defense: Classical Variation |  Advance Variation
1316,1442,48,resign,black,126,D32,Tarrasch Defense: Symmetrical Variation
2101,2048,24,time,black,53,D32,Tarrasch Defense: Symmetrical Variation
2291,2290,40,resign,black,1,D32,Tarrasch Defense: Two Knights Variation
1670,1692,64,resign,black,22,C46,Three Knights Opening
1701,1500,68,mate,black,201,C46,Three Knights Opening
1450,1390,32,resign,black,60,C46,Three Knights Opening
1694,1707,54,resign,black,13,C46,Three Knights Opening
1422,2026,40,mate,black,604,C46,Three Knights Opening
1552,1512,52,time,black,40,C46,Three Knights Opening
1208,1311,74,resign,black,103,C46,Three Knights Opening
1453,1380,118,mate,black,73,C46,Three Knights Opening
1632,1533,74,resign,black,99,C46,Three Knights Opening
1491,1383,152,resign,black,108,C46,Three Knights Opening
1077,1146,62,mate,black,69,C46,Three Knights Opening
1520,1717,28,resign,black,197,C46,Three Knights Opening
1351,1332,90,mate,black,19,C46,Three Knights Opening
1376,1462,58,mate,black,86,C46,Three Knights Opening
1410,1337,22,time,black,73,C46,Three Knights Opening
1702,1681,80,resign,black,21,C46,Three Knights Opening #2
1005,1140,48,resign,black,135,C46,Three Knights Opening #2
1253,1262,66,mate,black,9,C46,Three Knights Opening #2
1199,1659,46,resign,black,460,C46,Three Knights Opening #2
1313,1330,48,mate,black,17,C46,Three Knights Opening #2
1711,1724,47,resign,black,13,C46,Three Knights Opening: Winawer Defense
1665,1697,44,resign,black,32,C46,Three Knights Opening: Winawer Defense
1939,2129,92,resign,black,190,C46,Three Knights Opening: Winawer Defense
1715,1726,114,resign,black,11,A46,Torre Attack
1246,1238,72,resign,black,8,A46,Torre Attack #2
1266,1854,36,mate,black,588,A46,Torre Attack #2
1112,1073,72,mate,black,39,A46,Torre Attack #2
2000,2020,58,mate,black,20,A46,Torre Attack: Classical Defense |  Nimzowitsch Variation
2143,1916,34,resign,black,227,A45,Trompowsky Attack
1217,1282,62,resign,black,65,A45,Trompowsky Attack
2167,2172,88,mate,black,5,A45,Trompowsky Attack
1335,1329,50,resign,black,6,A45,Trompowsky Attack: Classical Defense
2045,2024,62,mate,black,21,A45,Trompowsky Attack: Classical Defense |  Big Center Variation
1608,1936,22,resign,black,328,A00,Valencia Opening
1209,1265,32,mate,black,56,A00,Van Geet Opening
1871,2264,38,resign,black,393,A00,Van Geet Opening
1051,1356,36,mate,black,305,A00,Van Geet Opening
1710,1431,28,mate,black,279,A00,Van Geet Opening
1178,1744,14,resign,black,566,A00,Van Geet Opening
1027,1478,16,mate,black,451,A00,Van Geet Opening
1201,1275,70,time,black,74,A00,Van Geet Opening
1081,1356,30,mate,black,275,A00,Van Geet Opening
1506,2221,70,resign,black,715,A00,Van Geet Opening
1208,1406,82,mate,black,198,A00,Van Geet Opening: Dunst-Perrenet Gambit
1536,1350,30,mate,black,186,A00,Van Geet Opening: Napoleon Attack
1072,1276,14,mate,black,204,A00,Van Geet Opening: Reversed Nimzowitsch
1272,1807,52,mate,black,535,A00,Van Geet Opening: Reversed Nimzowitsch
1765,1622,56,resign,black,143,A00,Van Geet Opening: Sicilian Two Knights
1942,1611,48,resign,black,331,A00,Van't Kruijs Opening
1620,1607,20,resign,black,13,A00,Van't Kruijs Opening
1016,1126,78,resign,black,110,A00,Van't Kruijs Opening
1367,1866,59,resign,black,499,A00,Van't Kruijs Opening
1376,1469,52,resign,black,93,A00,Van't Kruijs Opening
1070,1112,50,mate,black,42,A00,Van't Kruijs Opening
1605,1698,56,mate,black,93,A00,Van't Kruijs Opening
1622,1681,48,mate,black,59,A00,Van't Kruijs Opening
1500,1644,80,mate,black,144,A00,Van't Kruijs Opening
1602,1502,75,resign,black,100,A00,Van't Kruijs Opening
1707,1734,62,resign,black,27,A00,Van't Kruijs Opening
1235,1272,52,resign,black,37,A00,Van't Kruijs Opening
1327,1327,68,mate,black,0,A00,Van't Kruijs Opening
1340,1366,29,resign,black,26,A00,Van't Kruijs Opening
1195,1298,92,time,black,103,A00,Van't Kruijs Opening
1150,1202,40,resign,black,52,A00,Van't Kruijs Opening
1210,1334,45,resign,black,124,A00,Van't Kruijs Opening
1690,1712,102,mate,black,22,A00,Van't Kruijs Opening
1319,1480,46,mate,black,161,A00,Van't Kruijs Opening
1055,1280,2,resign,black,225,A00,Van't Kruijs Opening
1086,1148,8,resign,black,62,A00,Van't Kruijs Opening
1091,1958,62,mate,black,867,A00,Van't Kruijs Opening
1185,1171,26,mate,black,14,A00,Van't Kruijs Opening
1193,1636,38,mate,black,443,A00,Van't Kruijs Opening
1236,1373,44,mate,black,137,A00,Van't Kruijs Opening
1264,1506,64,mate,black,242,A00,Van't Kruijs Opening
1132,1258,8,resign,black,126,A00,Van't Kruijs Opening
1194,1311,52,mate,black,117,A00,Van't Kruijs Opening
1206,1132,102,mate,black,74,A00,Van't Kruijs Opening
1289,1321,34,mate,black,32,A00,Van't Kruijs Opening
1098,1249,106,mate,black,151,A00,Van't Kruijs Opening
1130,1210,124,mate,black,80,A00,Van't Kruijs Opening
1114,1384,88,mate,black,270,A00,Van't Kruijs Opening
1074,2151,28,mate,black,1077,A00,Van't Kruijs Opening
973,1173,42,resign,black,200,A00,Van't Kruijs Opening
1092,1143,36,mate,black,51,A00,Van't Kruijs Opening
1091,1645,31,resign,black,554,A00,Van't Kruijs Opening
1183,1248,54,mate,black,65,A00,Van't Kruijs Opening
1253,1556,76,mate,black,303,A00,Van't Kruijs Opening
1064,1144,74,time,black,80,A00,Van't Kruijs Opening
1473,1775,42,resign,black,302,A00,Van't Kruijs Opening
1481,1730,20,mate,black,249,A00,Van't Kruijs Opening
1492,1649,50,mate,black,157,A00,Van't Kruijs Opening
1559,1839,26,resign,black,280,A00,Van't Kruijs Opening
1073,1135,36,mate,black,62,A00,Van't Kruijs Opening
1574,1260,38,mate,black,314,A00,Van't Kruijs Opening
1184,1500,47,resign,black,316,A00,Van't Kruijs Opening
1408,1448,84,mate,black,40,A00,Van't Kruijs Opening
1650,1895,4,resign,black,245,A00,Van't Kruijs Opening
1221,1783,38,resign,black,562,A00,Van't Kruijs Opening
1214,1448,32,resign,black,234,A00,Van't Kruijs Opening
1117,1312,64,mate,black,195,A00,Van't Kruijs Opening
1543,1518,60,resign,black,25,A00,Van't Kruijs Opening
1401,1618,136,time,black,217,A00,Van't Kruijs Opening
1110,1292,62,mate,black,182,A00,Van't Kruijs Opening
1615,1636,80,resign,black,21,A00,Van't Kruijs Opening
1302,963,116,time,black,339,A00,Van't Kruijs Opening
1500,1500,182,resign,black,0,A00,Van't Kruijs Opening
1212,1359,82,mate,black,147,A00,Van't Kruijs Opening
1218,1393,30,resign,black,175,A00,Van't Kruijs Opening
1264,1242,96,mate,black,22,A00,Van't Kruijs Opening
1222,1519,29,resign,black,297,A00,Van't Kruijs Opening
1075,1524,32,mate,black,449,A00,Van't Kruijs Opening
1102,1323,6,resign,black,221,A00,Van't Kruijs Opening
1244,1273,42,mate,black,29,A00,Van't Kruijs Opening
1360,1332,22,mate,black,28,A00,Van't Kruijs Opening
1077,1299,118,mate,black,222,A00,Van't Kruijs Opening
1346,1536,80,mate,black,190,A00,Van't Kruijs Opening
1235,1296,64,time,black,61,A00,Van't Kruijs Opening
1515,1855,76,resign,black,340,A00,Van't Kruijs Opening
1797,2199,42,mate,black,402,A00,Van't Kruijs Opening
1799,2196,64,mate,black,397,A00,Van't Kruijs Opening
1500,1455,48,mate,black,45,A00,Van't Kruijs Opening
1467,2194,50,mate,black,727,A00,Van't Kruijs Opening
1328,1393,104,mate,black,65,A00,Van't Kruijs Opening
1511,1599,64,resign,black,88,A00,Van't Kruijs Opening
1900,2010,120,resign,black,110,A00,Van't Kruijs Opening
1498,1391,42,resign,black,107,A00,Van't Kruijs Opening
1148,1500,80,mate,black,352,A00,Van't Kruijs Opening
1382,1644,48,mate,black,262,A00,Van't Kruijs Opening
1285,1598,60,mate,black,313,C27,Vienna Game
1355,1592,69,resign,black,237,C27,Vienna Game
1386,1468,52,resign,black,82,C27,Vienna Game
1500,1435,46,resign,black,65,C27,Vienna Game
1026,1224,112,resign,black,198,C27,Vienna Game
1574,1303,102,mate,black,271,C27,Vienna Game
1915,1859,40,resign,black,56,C27,Vienna Game
2104,2456,26,resign,black,352,C27,Vienna Game #2
1255,1833,56,mate,black,578,C25,Vienna Game: Anderssen Defense
1954,1771,70,resign,black,183,C25,Vienna Game: Anderssen Defense
1216,1352,80,resign,black,136,C25,Vienna Game: Max Lange Defense
1476,1746,98,mate,black,270,C25,Vienna Game: Max Lange Defense
1369,1307,134,mate,black,62,C26,Vienna Game: Mengarini Variation
1500,1473,70,mate,black,27,C25,Vienna Game: Paulsen Variation
1354,1483,79,resign,black,129,C25,Vienna Game: Paulsen Variation
1308,1441,78,resign,black,133,C26,Vienna Game: Stanley Variation
1853,1523,114,resign,black,330,C26,Vienna Game: Stanley Variation
2301,2449,32,resign,black,148,C29,Vienna Game: Vienna Gambit |  Main Line
1429,1487,66,resign,black,58,C25,Vienna Game: Zhuravlev Countergambit #2
1279,1576,50,resign,black,297,B00,Ware Defense
1750,1715,78,mate,black,35,B00,Ware Defense
914,1141,4,resign,black,227,A00,Ware Opening
958,1289,70,mate,black,331,A00,Ware Opening
1035,1603,10,resign,black,568,A00,Ware Opening
1124,1790,38,mate,black,666,A00,Ware Opening
1115,1219,37,resign,black,104,A00,Ware Opening
1795,1760,40,resign,black,35,A46,Yusupov-Rubinstein System
1734,1688,79,resign,black,46,A46,Yusupov-Rubinstein System
1500,1707,36,time,black,207,A46,Yusupov-Rubinstein System
1901,1718,48,resign,black,183,A46,Yusupov-Rubinstein System
1850,1905,52,mate,black,55,A46,Yusupov-Rubinstein System
1217,1259,50,mate,black,42,A04,Zukertort Opening: Arctic Defense
1680,1633,38,resign,black,47,A04,Zukertort Opening: Arctic Defense
1381,1393,88,mate,black,12,A04,Zukertort Opening: Black Mustang Defense
1591,1647,21,resign,black,56,A04,Zukertort Opening: Black Mustang Defense
1948,1948,110,resign,black,0,A04,Zukertort Opening: Black Mustang Defense
1271,1517,52,mate,black,246,A04,Zukertort Opening: Black Mustang Defense
1721,1679,36,mate,black,42,A04,Zukertort Opening: Black Mustang Defense
1452,1549,18,mate,black,97,A04,Zukertort Opening: Black Mustang Defense
1269,1219,38,mate,black,50,A04,Zukertort Opening: Black Mustang Defense
1493,1546,62,mate,black,53,A04,Zukertort Opening: Black Mustang Defense
1445,1564,108,mate,black,119,A04,Zukertort Opening: Black Mustang Defense
1062,1322,50,mate,black,260,A04,Zukertort Opening: Kingside Fianchetto
1870,2073,44,resign,black,203,A04,Zukertort Opening: Kingside Fianchetto
1884,1932,16,resign,black,48,A04,Zukertort Opening: Lisitsyn Gambit
1781,1956,54,mate,black,175,A06,Zukertort Opening: Old Indian Attack
1834,1896,32,resign,black,62,A06,Zukertort Opening: Old Indian Attack
1413,1401,62,mate,black,12,A04,Zukertort Opening: Pirc Invitation
1405,1402,56,resign,black,3,A04,Zukertort Opening: Pirc Invitation
1317,1049,58,mate,black,268,A04,Zukertort Opening: Pirc Invitation
1868,1716,107,resign,black,152,A04,Zukertort Opening: Pirc Invitation
1498,1469,48,resign,black,29,A04,Zukertort Opening: Pirc Invitation
1350,1204,68,mate,black,146,A04,Zukertort Opening: Pirc Invitation
2082,1970,68,resign,black,112,A04,Zukertort Opening: Polish Defense
1885,1960,20,resign,black,75,A04,Zukertort Opening: Polish Defense
1432,1382,96,mate,black,50,A04,Zukertort Opening: Queen's Gambit Invitation
1459,1569,76,resign,black,110,A04,Zukertort Opening: Queen's Gambit Invitation
1531,1539,48,mate,black,8,A04,Zukertort Opening: Queen's Gambit Invitation
1811,1755,106,resign,black,56,A04,Zukertort Opening: Queen's Gambit Invitation
1635,1631,40,mate,black,4,A04,Zukertort Opening: Queenside Fianchetto Variation
1626,1612,36,resign,black,14,A04,Zukertort Opening: Queenside Fianchetto Variation
1500,1406,28,mate,black,94,A06,Zukertort Opening: Reversed Mexican Defense
946,1250,18,resign,black,304,A06,Zukertort Opening: Reversed Mexican Defense
1037,1658,30,resign,black,621,A06,Zukertort Opening: Reversed Mexican Defense
1202,1347,32,resign,black,145,A06,Zukertort Opening: Reversed Mexican Defense
1211,1804,12,resign,black,593,A06,Zukertort Opening: Reversed Mexican Defense
1483,1708,70,resign,black,225,A04,Zukertort Opening: Ross Gambit
1950,1926,90,mate,black,24,A06,Zukertort Opening: Santasiere's Folly
1866,2309,28,resign,black,443,A04,Zukertort Opening: Sicilian Invitation
1927,1916,108,mate,black,11,A04,Zukertort Opening: Sicilian Invitation
1897,2003,60,resign,black,106,A04,Zukertort Opening: Sicilian Invitation
1463,1974,90,resign,black,511,A06,Zukertort Opening: Tennison Gambit
1649,1606,62,resign,black,43,A06,Zukertort Opening: Tennison Gambit
1569,1710,64,resign,black,141,A06,Zukertort Opening: Tennison Gambit
1103,1240,26,mate,black,137,A06,Zukertort Opening: Tennison Gambit
1488,1438,31,resign,black,50,A06,Zukertort Opening: Tennison Gambit
1350,1198,74,resign,black,152,A06,Zukertort Opening: Tennison Gambit
1422,1467,32,resign,black,45,A06,Zukertort Opening: Tennison Gambit
1842,2137,42,resign,black,295,A06,Zukertort Opening: Tennison Gambit
1913,1925,82,resign,black,12,A06,Zukertort Opening: Tennison Gambit
1875,2042,50,resign,black,167,A06,Zukertort Opening: Tennison Gambit
1781,1930,70,resign,black,149,A06,Zukertort Opening: Tennison Gambit
1172,1199,98,mate,black,27,A04,Zukertort Opening: Vos Gambit
1431,1418,66,draw,draw,13,B02,Alekhine Defense
1849,1826,13,draw,draw,23,B03,Alekhine Defense #2
1189,1164,35,draw,draw,25,B02,Alekhine Defense: Mokele Mbembe
1387,1507,86,draw,draw,120,B02,Alekhine Defense: Normal Variation
1500,1017,8,draw,draw,483,D00,Amazon Attack
1588,1696,117,draw,draw,108,A00,Anderssen Opening
1331,1296,100,draw,draw,35,B00,Barnes Defense
1662,1337,26,draw,draw,325,A43,Benoni Defense: Benoni Gambit Accepted
1662,1337,26,draw,draw,325,A43,Benoni Defense: Benoni Gambit Accepted
1847,1541,113,time,draw,306,A43,Benoni Defense: Benoni Gambit Accepted
1531,1430,96,draw,draw,101,A43,Benoni Defense: Benoni Gambit Accepted
2428,2360,153,draw,draw,68,A71,Benoni Defense: Classical Variation |  Averbakh-Grivas Attack
1174,956,111,draw,draw,218,A03,Bird Opening
1511,1363,96,draw,draw,148,A03,Bird Opening: Dutch Variation
1494,1433,61,draw,draw,61,C23,Bishop's Opening
1382,1304,17,draw,draw,78,C23,Bishop's Opening
1154,1148,32,draw,draw,6,C23,Bishop's Opening
1579,1331,67,draw,draw,248,C23,Bishop's Opening
1436,1525,27,draw,draw,89,C23,Bishop's Opening
1880,1886,3,draw,draw,6,C23,Bishop's Opening
1635,1723,89,draw,draw,88,E11,Bogo-Indian Defense: Exchange Variation
1694,1709,150,draw,draw,15,B10,Caro-Kann Defense
1275,1398,130,draw,draw,123,B10,Caro-Kann Defense #2
1530,1635,45,draw,draw,105,B13,Caro-Kann Defense: Exchange Variation
1666,1701,122,draw,draw,35,B14,Caro-Kann Defense: Panov Attack
1686,1098,128,draw,draw,588,B00,Carr Defense
1702,1700,65,draw,draw,2,C21,Danish Gambit
1813,1850,104,draw,draw,37,A80,Dutch Defense
1465,1659,63,draw,draw,194,A81,Dutch Defense: Fianchetto Attack
2353,2313,50,draw,draw,40,A85,Dutch Defense: Queen's Knight Variation
1845,1844,90,draw,draw,1,A13,English Opening: Agincourt Defense
2029,2047,98,draw,draw,18,A13,English Opening: Agincourt Defense #2
2277,1893,122,draw,draw,384,A16,English Opening: Anglo-Indian Defense |  Anglo-Gruenfeld Variation #3
1696,1564,135,draw,draw,132,A10,English Opening: Great Snake Variation
972,1247,163,time,draw,275,A20,English Opening: King's English Variation
1913,1754,131,draw,draw,159,A28,English Opening: King's English Variation |  Four Knights Variation |  Quiet Line #3
1530,1543,96,draw,draw,13,A40,Englund Gambit
1517,1134,8,draw,draw,383,A40,Englund Gambit Complex: Englund Gambit
1462,1158,130,draw,draw,304,C46,Four Knights Game
1107,1332,121,draw,draw,225,C49,Four Knights Game: Double Spanish
1139,1212,120,draw,draw,73,C50,Four Knights Game: Italian Variation
1376,1472,20,draw,draw,96,C50,Four Knights Game: Italian Variation
1449,1597,99,draw,draw,148,C48,Four Knights Game: Ranken Variation
1141,1138,107,draw,draw,3,C47,Four Knights Game: Scotch Variation
1776,1949,57,draw,draw,173,C48,Four Knights Game: Spanish Variation
1126,950,106,draw,draw,176,C00,French Defense #2
1075,1120,82,draw,draw,45,C00,French Defense #2
1291,1451,39,draw,draw,160,C02,French Defense: Advance Variation #2
1936,1843,77,draw,draw,93,C02,French Defense: Advance Variation |  Milner-Barry Gambit
1621,1325,105,draw,draw,296,C02,French Defense: Advance Variation |  Nimzowitsch System
2177,2051,41,draw,draw,126,C02,French Defense: Advance Variation |  Paulsen Attack
1450,1525,114,draw,draw,75,C02,French Defense: Advance Variation |  Paulsen Attack
1452,1351,125,draw,draw,101,C02,French Defense: Advance Variation |  Paulsen Attack
1986,1993,142,draw,draw,7,C13,French Defense: Alekhine-Chatard Attack |  Maroczy Variation
1674,2022,32,draw,draw,348,C11,French Defense: Burn Variation
1155,1424,14,draw,draw,269,C11,French Defense: Classical Variation
1804,1869,86,draw,draw,65,C01,French Defense: Exchange Variation
1712,1751,137,draw,draw,39,C01,French Defense: Exchange Variation
1501,1255,36,draw,draw,246,C01,French Defense: Exchange Variation
1698,1720,98,draw,draw,22,C01,French Defense: Exchange Variation
2155,1758,118,draw,draw,397,C00,French Defense: Horwitz Attack
1618,1609,48,draw,draw,9,C00,French Defense: Knight Variation
1383,1045,112,draw,draw,338,C00,French Defense: Knight Variation
1775,1544,68,draw,draw,231,C00,French Defense: Knight Variation
1736,1832,93,draw,draw,96,C00,French Defense: Knight Variation
1428,1527,68,draw,draw,99,C00,French Defense: Knight Variation
1025,1153,89,time,draw,128,C01,French Defense: Mediterranean Defense
1450,1468,113,draw,draw,18,C00,French Defense: Normal Variation
1813,1834,156,draw,draw,21,C00,French Defense: Normal Variation
2018,1527,86,draw,draw,491,C10,French Defense: Paulsen Variation
1339,1339,52,draw,draw,0,C00,French Defense: Queen's Knight
1585,1448,255,draw,draw,137,C00,French Defense: Queen's Knight
1401,1477,75,draw,draw,76,C10,French Defense: Rubinstein Variation
1774,1648,14,draw,draw,126,C10,French Defense: Rubinstein Variation |  Blackburne Defense
1864,1823,96,draw,draw,41,C10,French Defense: Rubinstein Variation |  Fort Knox Variation
1964,1818,145,time,draw,146,C10,French Defense: Rubinstein Variation |  Fort Knox Variation
1456,1789,97,draw,draw,333,C00,French Defense: Steinitz Attack
2111,2044,221,draw,draw,67,C50,Giuoco Piano
1020,1228,124,draw,draw,208,A00,Grob Opening
1770,1774,73,draw,draw,4,D93,Gruenfeld Defense: Three Knights Variation |  Hungarian Variation
1009,1038,88,time,draw,29,A40,Horwitz Defense
2109,1913,132,draw,draw,196,A40,Horwitz Defense
1386,1279,43,draw,draw,107,A00,Hungarian Opening
1646,1696,2,draw,draw,50,A45,Indian Game
1639,1663,143,draw,draw,24,A45,Indian Game
1727,1627,139,time,draw,100,A45,Indian Game
2180,2186,42,draw,draw,6,A46,Indian Game: Spielmann-Indian
1693,1621,114,draw,draw,72,E61,Indian Game: West Indian Defense
1717,1985,97,draw,draw,268,E61,Indian Game: West Indian Defense
1215,1219,12,draw,draw,4,C50,Italian Game
1568,1617,137,draw,draw,49,C50,Italian Game
1156,886,86,draw,draw,270,C50,Italian Game
1561,1525,113,draw,draw,36,C50,Italian Game
1420,1239,38,draw,draw,181,C50,Italian Game
1996,1916,97,draw,draw,80,C50,Italian Game
1433,1315,84,draw,draw,118,C50,Italian Game
1259,1663,150,draw,draw,404,C55,Italian Game: Anti-Fried Liver Defense
1570,1555,71,draw,draw,15,C55,Italian Game: Anti-Fried Liver Defense
1696,1722,147,draw,draw,26,C55,Italian Game: Anti-Fried Liver Defense
1949,2057,90,draw,draw,108,C53,Italian Game: Classical Variation |  Giuoco Pianissimo
1510,1488,124,draw,draw,22,C54,Italian Game: Classical Variation |  Greco Gambit |  Traditional Line
1705,1709,114,draw,draw,4,C50,Italian Game: Giuoco Pianissimo |  Italian Four Knights Variation
1588,1691,110,draw,draw,103,C50,Italian Game: Giuoco Pianissimo |  Normal
1346,1343,24,draw,draw,3,C50,Italian Game: Schilling-Kostic Gambit
1211,1226,30,draw,draw,15,C55,Italian Game: Two Knights Defense
2235,2258,69,draw,draw,23,C57,Italian Game: Two Knights Defense |  Fried Liver Attack
1859,1674,110,draw,draw,185,C55,Italian Game: Two Knights Defense |  Max Lange Attack
1866,1835,107,draw,draw,31,C55,Italian Game: Two Knights Defense |  Modern Bishop's Opening
1584,1648,29,draw,draw,64,C55,Italian Game: Two Knights Defense |  Modern Bishop's Opening
1757,1748,47,draw,draw,9,C57,Italian Game: Two Knights Defense |  Ulvestad Variation
1064,1174,109,draw,draw,110,C33,King's Gambit Accepted
1814,1568,101,draw,draw,246,C30,King's Gambit Declined |  Queen's Knight Defense
1973,2003,81,draw,draw,30,A08,King's Indian Attack
1941,1916,109,draw,draw,25,A05,King's Indian Attack: Symmetrical Defense
1903,1969,130,draw,draw,66,A05,King's Indian Attack: Wahls Defense
1653,1633,110,draw,draw,20,E60,King's Indian Defense: Normal Variation |  King's Knight Variation
1794,1714,71,draw,draw,80,E76,King's Indian Defense: Steiner Attack
1563,1396,3,draw,draw,167,C40,King's Knight Opening
1514,1479,99,draw,draw,35,C44,King's Knight Opening: Normal Variation
1004,1085,101,draw,draw,81,C40,King's Pawn Game: Busch-Gass Gambit
1514,1477,114,time,draw,37,C40,King's Pawn Game: Damiano Defense
1180,1091,113,draw,draw,89,C40,King's Pawn Game: Damiano Defense
1414,983,6,draw,draw,431,C20,King's Pawn Game: Leonardis Variation
962,1133,54,draw,draw,171,B07,King's Pawn Game: Maroczy Defense
1500,1897,99,draw,draw,397,B07,King's Pawn Game: Maroczy Defense
1264,1268,22,draw,draw,4,C40,King's Pawn Game: McConnell Defense
1552,1491,131,draw,draw,61,C20,King's Pawn Game: Mengarini's Opening
1352,1364,14,draw,draw,12,C20,King's Pawn Game: Napoleon Attack
1129,1248,100,draw,draw,119,C20,King's Pawn Game: Napoleon Attack
1323,1365,38,draw,draw,42,C20,King's Pawn Game: Wayward Queen Attack
1455,1510,159,draw,draw,55,C20,King's Pawn Game: Wayward Queen Attack
1496,1703,195,draw,draw,207,A48,London System
2040,2066,103,draw,draw,26,A48,London System
1596,1686,116,draw,draw,90,A40,Modern Defense
1832,1752,116,draw,draw,80,B06,Modern Defense
1710,2053,130,draw,draw,343,E32,Nimzo-Indian Defense: Classical Variation
2474,2477,91,draw,draw,3,E30,Nimzo-Indian Defense: Leningrad Variation
1838,1877,45,draw,draw,39,E20,Nimzo-Indian Defense: Ragozin Variation
1500,1210,11,draw,draw,290,A01,Nimzo-Larsen Attack
1500,1210,11,draw,draw,290,A01,Nimzo-Larsen Attack
1459,1462,161,draw,draw,3,A01,Nimzo-Larsen Attack: Modern Variation
1291,1166,95,time,draw,125,B00,Nimzowitsch Defense: Williams Variation
1632,1621,151,draw,draw,11,A53,Old Indian Defense
1196,946,21,draw,draw,250,B00,Owen Defense
1573,1599,87,draw,draw,26,B00,Owen Defense
1418,1480,111,draw,draw,62,B00,Owen Defense
1817,1688,115,draw,draw,129,C42,Petrov's Defense #4
1275,1467,26,draw,draw,192,C43,Petrov: Modern Attack
1626,1599,60,draw,draw,27,C43,Petrov: Modern Attack
1437,1333,115,draw,draw,104,C41,Philidor Defense
1289,1372,100,draw,draw,83,C41,Philidor Defense
1500,1429,143,draw,draw,71,C41,Philidor Defense
1428,1507,33,draw,draw,79,C41,Philidor Defense #2
1500,1770,43,draw,draw,270,C41,Philidor Defense #2
1467,1501,77,draw,draw,34,C41,Philidor Defense #2
1546,1522,63,draw,draw,24,C41,Philidor Defense #2
1705,1628,117,draw,draw,77,C41,Philidor Defense #3
1372,1347,109,draw,draw,25,C41,Philidor Defense #3
1629,1586,44,draw,draw,43,B07,Pirc Defense
1642,1638,88,draw,draw,4,B07,Pirc Defense #4
1421,1413,119,draw,draw,8,B07,Pirc Defense #4
1518,1431,8,draw,draw,87,B07,Pirc Defense #4
1302,1116,48,draw,draw,186,A00,Polish Opening
1742,1372,111,draw,draw,370,A00,Polish Opening: Grigorian Variation
1603,1475,116,draw,draw,128,C44,Ponziani Opening: Jaenisch Counterattack
1152,1162,123,time,draw,10,D20,Queen's Gambit Accepted
1727,1586,96,draw,draw,141,D20,Queen's Gambit Accepted: Old Variation
1558,1657,74,draw,draw,99,D20,Queen's Gambit Accepted: Old Variation
1759,1364,89,draw,draw,395,D20,Queen's Gambit Accepted: Saduleto Variation
1956,1862,113,draw,draw,94,D52,Queen's Gambit Declined
1500,1516,94,draw,draw,16,D30,Queen's Gambit Declined
1350,1429,57,draw,draw,79,D35,Queen's Gambit Declined: Exchange Variation |  Positional Variation
1465,1449,208,time,draw,16,D50,Queen's Gambit Declined: Pseudo-Tarrasch Variation
1534,1357,56,draw,draw,177,D37,Queen's Gambit Declined: Three Knights Variation
1749,1702,75,draw,draw,47,D37,Queen's Gambit Declined: Three Knights Variation
1589,1606,84,draw,draw,17,D06,Queen's Gambit Refused: Austrian Defense
1500,1524,31,draw,draw,24,D07,Queen's Gambit Refused: Chigorin Defense
1449,1485,79,draw,draw,36,D07,Queen's Gambit Refused: Chigorin Defense |  Main Line
1745,1714,113,draw,draw,31,D06,Queen's Gambit Refused: Marshall Defense
1677,1716,3,draw,draw,39,A40,Queen's Pawn
1862,1698,164,time,draw,164,A40,Queen's Pawn
1638,1417,104,draw,draw,221,D00,Queen's Pawn Game
1250,1382,39,draw,draw,132,D00,Queen's Pawn Game
1677,1639,125,draw,draw,38,D00,Queen's Pawn Game
1292,1339,3,draw,draw,47,D00,Queen's Pawn Game #2
1304,1287,115,time,draw,17,D00,Queen's Pawn Game #2
1057,1595,150,draw,draw,538,D00,Queen's Pawn Game #3
1580,1420,103,draw,draw,160,D02,Queen's Pawn Game: Chigorin Variation
1938,1980,105,draw,draw,42,D01,Queen's Pawn Game: Chigorin Variation
1216,1093,12,draw,draw,123,C00,Queen's Pawn Game: Franco-Sicilian Defense
1371,1573,148,draw,draw,202,D02,Queen's Pawn Game: Krause Variation
2199,2179,100,draw,draw,20,D02,Queen's Pawn Game: London System
2025,2004,126,draw,draw,21,D02,Queen's Pawn Game: London System
1071,1068,71,draw,draw,3,D00,Queen's Pawn Game: Mason Attack
1529,1763,148,time,draw,234,D00,Queen's Pawn Game: Mason Attack
2465,2384,33,draw,draw,81,D00,Queen's Pawn Game: Mason Attack
1469,1524,128,draw,draw,55,D00,Queen's Pawn Game: Mason Attack
1651,1608,118,draw,draw,43,D00,Queen's Pawn Game: Steinitz Countergambit
1954,1859,173,draw,draw,95,D00,Queen's Pawn Game: Steinitz Countergambit
1234,1335,11,draw,draw,101,D02,Queen's Pawn Game: Symmetrical Variation
1836,1925,101,draw,draw,89,D02,Queen's Pawn Game: Symmetrical Variation
2153,2474,178,draw,draw,321,D02,Queen's Pawn Game: Symmetrical Variation |  Pseudo-Catalan
1776,1736,112,draw,draw,40,D02,Queen's Pawn Game: Symmetrical Variation |  Pseudo-Catalan
1979,1905,50,draw,draw,74,D02,Queen's Pawn Game: Zukertort Variation
1783,1595,111,draw,draw,188,D02,Queen's Pawn Game: Zukertort Variation
1768,1824,143,draw,draw,56,C00,Rat Defense: Small Center Defense
937,1233,37,draw,draw,296,A06,Reti Opening
1659,1628,117,draw,draw,31,A06,Reti Opening
1414,1159,10,draw,draw,255,B06,Robatsch (Modern) Defense
2225,2264,173,time,draw,39,C42,Russian Game: Classical Attack |  Chigorin Variation
1330,1268,92,draw,draw,62,C42,Russian Game: Three Knights Game
1691,1386,100,draw,draw,305,C42,Russian Game: Urusov Gambit
1744,1440,106,draw,draw,304,C60,Ruy Lopez
1176,1090,19,draw,draw,86,C65,Ruy Lopez: Berlin Defense
1417,1463,109,draw,draw,46,C65,Ruy Lopez: Berlin Defense |  Beverwijk Variation
1708,1694,157,draw,draw,14,C66,Ruy Lopez: Berlin Defense |  Improved Steinitz Defense
1682,1629,146,draw,draw,53,C66,Ruy Lopez: Berlin Defense |  Improved Steinitz Defense
1731,1879,67,draw,draw,148,C67,Ruy Lopez: Berlin Defense |  Rio Gambit Accepted
1355,1409,46,draw,draw,54,C67,Ruy Lopez: Berlin Defense |  Rio Gambit Accepted
1645,1702,105,draw,draw,57,C64,Ruy Lopez: Classical Variation
1170,1302,85,draw,draw,132,C92,Ruy Lopez: Closed Variations |  Flohr System
1873,1803,132,draw,draw,70,C60,Ruy Lopez: Cozio Defense
1707,1881,113,draw,draw,174,C69,Ruy Lopez: Exchange Variation |  Bronstein Variation
1975,1750,29,draw,draw,225,C68,Ruy Lopez: Exchange Variation |  King's Bishop Variation
2050,1981,33,draw,draw,69,C89,Ruy Lopez: Marshall Attack
1721,1249,75,draw,draw,472,C78,Ruy Lopez: Morphy Defense
1313,1335,28,draw,draw,22,C70,Ruy Lopez: Morphy Defense |  Caro Variation
1509,1573,95,draw,draw,64,C62,Ruy Lopez: Steinitz Defense
1641,1502,2,draw,draw,139,B01,Scandinavian Defense
1356,1491,46,draw,draw,135,B01,Scandinavian Defense
1982,1960,56,draw,draw,22,B01,Scandinavian Defense
1116,1173,65,draw,draw,57,B01,Scandinavian Defense
1160,1164,104,draw,draw,4,B01,Scandinavian Defense
1309,1305,52,draw,draw,4,B01,Scandinavian Defense
1224,1148,14,draw,draw,76,B01,Scandinavian Defense
1660,1852,66,draw,draw,192,B01,Scandinavian Defense: Anderssen Counterattack |  Goteborg System
1647,1647,73,draw,draw,0,B01,Scandinavian Defense: Main Line |  Mieses Variation
1945,1961,48,draw,draw,16,B01,Scandinavian Defense: Marshall Variation
1914,1965,148,draw,draw,51,B01,Scandinavian Defense: Modern Variation #2
2111,1981,118,draw,draw,130,B01,Scandinavian Defense: Portuguese Variation
1431,1585,96,draw,draw,154,C45,Scotch Game: Schmidt Variation
1989,1868,55,draw,draw,121,D43,Semi-Slav Defense
1875,1821,57,draw,draw,54,D43,Semi-Slav Defense
1872,1876,178,draw,draw,4,D43,Semi-Slav Defense
1879,1863,123,draw,draw,16,D46,Semi-Slav Defense: Bogoljubov Variation
1611,2059,69,draw,draw,448,D46,Semi-Slav Defense: Chigorin Defense
2214,2187,63,draw,draw,27,D45,Semi-Slav Defense: Main Line
1134,1346,127,draw,draw,212,B20,Sicilian Defense
1845,1841,99,draw,draw,4,B50,Sicilian Defense
1661,1661,18,draw,draw,0,B50,Sicilian Defense
2273,2225,112,draw,draw,48,B50,Sicilian Defense
1761,1712,97,draw,draw,49,B54,Sicilian Defense #2
2220,2374,136,draw,draw,154,B35,Sicilian Defense: Accelerated Dragon |  Modern Bc4 Variation
1942,2119,3,draw,draw,177,B22,Sicilian Defense: Alapin Variation
1015,956,28,draw,draw,59,B20,Sicilian Defense: Bowdler Attack
1456,1556,42,draw,draw,100,B20,Sicilian Defense: Bowdler Attack
1542,1537,140,time,draw,5,B20,Sicilian Defense: Bowdler Attack
1194,1255,22,draw,draw,61,B20,Sicilian Defense: Bowdler Attack
1404,1418,94,draw,draw,14,B20,Sicilian Defense: Bowdler Attack
1401,1296,56,draw,draw,105,B20,Sicilian Defense: Bowdler Attack
2264,1639,140,draw,draw,625,B57,Sicilian Defense: Classical Variation |  Anti-Sozin Variation
2252,2295,68,draw,draw,43,B23,Sicilian Defense: Closed Variation
1204,1379,96,draw,draw,175,B23,Sicilian Defense: Closed Variation
2007,1500,24,draw,draw,507,B24,Sicilian Defense: Closed Variation |  Fianchetto Variation
983,1167,93,draw,draw,184,B50,Sicilian Defense: Delayed Alapin
1777,1998,96,draw,draw,221,B40,Sicilian Defense: Delayed Alapin Variation
1988,1730,120,draw,draw,258,B78,Sicilian Defense: Dragon Variation |  Yugoslav Attack
1972,1878,140,draw,draw,94,B41,Sicilian Defense: Kan Variation |  Maroczy Bind |  Reti Variation
1869,1939,135,time,draw,70,B20,Sicilian Defense: Lasker-Dunne Attack
1362,1529,50,draw,draw,167,B32,Sicilian Defense: Loewenthal Variation
1710,1741,86,draw,draw,31,B40,Sicilian Defense: Marshall Counterattack
1691,1451,64,draw,draw,240,B21,Sicilian Defense: McDonnell Attack
1845,1750,9,draw,draw,95,B56,Sicilian Defense: Modern Variations
1554,1535,154,draw,draw,19,B90,Sicilian Defense: Najdorf |  Lipnitsky Attack
1852,1836,119,draw,draw,16,B30,Sicilian Defense: Old Sicilian
1542,1954,104,draw,draw,412,B30,Sicilian Defense: Old Sicilian
1978,2061,152,time,draw,83,B30,Sicilian Defense: Old Sicilian
1976,1848,139,draw,draw,128,B32,Sicilian Defense: Open #2
1729,2008,103,draw,draw,279,B32,Sicilian Defense: Open #3
1885,1837,133,draw,draw,48,B46,Sicilian Defense: Paulsen Variation
1614,1673,99,draw,draw,59,B45,Sicilian Defense: Paulsen Variation |  Normal Variation
1766,1852,75,draw,draw,86,B44,Sicilian Defense: Paulsen Variation |  Szen Variation
1397,1405,107,draw,draw,8,B21,Sicilian Defense: Smith-Morra Gambit #2
1398,1465,127,draw,draw,67,B21,Sicilian Defense: Smith-Morra Gambit #2
1359,1440,72,draw,draw,81,B21,Sicilian Defense: Smith-Morra Gambit #2
1608,1591,68,draw,draw,17,B21,Sicilian Defense: Smith-Morra Gambit #2
1527,1565,43,draw,draw,38,B21,Sicilian Defense: Smith-Morra Gambit Accepted |  Scheveningen Formation
1745,1707,100,draw,draw,38,B57,Sicilian Defense: Sozin |  not Scheveningen
1590,1561,67,draw,draw,29,B20,Sicilian Defense: Staunton-Cochrane Variation
1812,1874,105,draw,draw,62,D10,Slav Defense
1312,1316,137,draw,draw,4,D10,Slav Defense
1284,1348,64,draw,draw,64,D10,Slav Defense #2
1806,1875,124,draw,draw,69,D12,Slav Defense: Exchange Variation |  Schallopp Variation
1559,1472,41,draw,draw,87,D11,Slav Defense: Modern Line
1893,1700,72,draw,draw,193,D12,Slav Defense: Quiet Variation |  Pin Defense
1820,1616,118,time,draw,204,D15,Slav Defense: Three Knights Variation
1372,1326,110,draw,draw,46,B00,St. George Defense
1454,1489,99,draw,draw,35,C46,Three Knights Opening
1432,1568,80,draw,draw,136,C46,Three Knights Opening
1566,1585,107,draw,draw,19,C46,Three Knights Opening: Steinitz Defense
2148,2213,99,draw,draw,65,A46,Torre Attack
1174,1254,124,draw,draw,80,A45,Trompowsky Attack
1463,1405,86,draw,draw,58,A45,Trompowsky Attack
2322,2472,115,draw,draw,150,A00,Van Geet Opening: Dunst-Perrenet Gambit
1191,1111,51,draw,draw,80,A00,Van't Kruijs Opening
1815,1882,64,draw,draw,67,A00,Van't Kruijs Opening
1752,1744,115,draw,draw,8,A00,Van't Kruijs Opening
2052,2162,119,draw,draw,110,C25,Vienna Game: Anderssen Defense
1383,1428,114,draw,draw,45,C26,Vienna Game: Mieses Variation
1926,1737,92,draw,draw,189,A04,Zukertort Opening: Queenside Fianchetto Variation
954,1166,44,draw,draw,212,A04,Zukertort Opening: Queenside Fianchetto Variation
1952,1907,158,time,draw,45,A04,Zukertort Opening: Queenside Fianchetto Variation
1970,1835,80,draw,draw,135,A04,Zukertort Opening: Sicilian Invitation
1680,1700,79,draw,draw,20,A04,Zukertort Opening: Sicilian Invitation
1467,1686,117,draw,draw,219,A04,Zukertort Opening: Sicilian Invitation
1270,1179,19,draw,draw,91,A06,Zukertort Opening: Tennison Gambit
1357,1471,5,draw,draw,114,A06,Zukertort Opening: Tennison Gambit
1325,1234,11,resign,white,91,B02,Alekhine Defense
1863,1567,47,resign,white,296,B02,Alekhine Defense
1562,1582,39,resign,white,20,B03,Alekhine Defense
1548,1488,34,resign,white,60,B03,Alekhine Defense
1699,1366,107,mate,white,333,B02,Alekhine Defense
1639,1203,85,resign,white,436,B02,Alekhine Defense
1598,1053,11,mate,white,545,B02,Alekhine Defense
1477,1203,121,mate,white,274,B02,Alekhine Defense
1403,1486,85,mate,white,83,B02,Alekhine Defense
1442,1041,49,mate,white,401,B02,Alekhine Defense
1378,1318,59,mate,white,60,B02,Alekhine Defense: Brooklyn Variation
1435,1216,27,mate,white,219,B02,Alekhine Defense: Brooklyn Variation
1804,2023,99,resign,white,219,B03,Alekhine Defense: Exchange Variation
2241,2244,55,resign,white,3,B03,Alekhine Defense: Exchange Variation
1662,1692,77,resign,white,30,B03,Alekhine Defense: Four Pawns Attack |  Trifunovic Variation
1319,1037,29,resign,white,282,B02,Alekhine Defense: John Tracy Gambit
1675,1322,42,resign,white,353,B02,Alekhine Defense: John Tracy Gambit
1433,1282,37,resign,white,151,B02,Alekhine Defense: Maroczy Variation
1359,1044,81,mate,white,315,B02,Alekhine Defense: Maroczy Variation
1581,1493,39,resign,white,88,B02,Alekhine Defense: Maroczy Variation
1500,1627,43,resign,white,127,B04,Alekhine Defense: Modern Variation |  Larsen Variation
1102,930,9,resign,white,172,B02,Alekhine Defense: Mokele Mbembe
1076,1171,123,mate,white,95,B02,Alekhine Defense: Mokele Mbembe
1415,1319,49,time,white,96,B02,Alekhine Defense: Mokele Mbembe
1328,1133,49,resign,white,195,B02,Alekhine Defense: Mokele Mbembe |  Vavra Defense
1755,1477,31,resign,white,278,B02,Alekhine Defense: Mokele Mbembe |  Vavra Defense
1176,950,61,resign,white,226,B02,Alekhine Defense: Mokele Mbembe |  Vavra Defense
1941,1687,23,time,white,254,B02,Alekhine Defense: Mokele Mbembe |  Vavra Defense
1898,1017,61,mate,white,881,B02,Alekhine Defense: Normal Variation
1547,1563,21,resign,white,16,B02,Alekhine Defense: Scandinavian Variation
1326,1355,51,resign,white,29,B02,Alekhine Defense: Scandinavian Variation
1323,1340,27,mate,white,17,B02,Alekhine Defense: Scandinavian Variation
1858,1932,61,resign,white,74,B02,Alekhine Defense: Scandinavian Variation
1738,1633,83,resign,white,105,B02,Alekhine Defense: Two Pawn Attack
1855,1858,69,time,white,3,E00,Amar Opening
1366,1500,57,mate,white,134,E00,Amar Opening
1348,1545,5,resign,white,197,E00,Amar Opening
1085,1082,81,mate,white,3,D00,Amazon Attack
1483,1478,15,resign,white,5,D00,Amazon Attack: Siberian Attack
1641,1490,35,mate,white,151,A00,Anderssen Opening
1636,1260,63,mate,white,376,A00,Anderssen Opening
1625,1378,20,resign,white,247,A00,Anderssen Opening
2250,2119,51,mate,white,131,A00,Anderssen Opening
2246,2204,61,resign,white,42,A00,Anderssen Opening
1669,1538,36,resign,white,131,A00,Anderssen Opening
1885,1460,35,mate,white,425,A40,Australian Defense
1381,1181,81,resign,white,200,B00,Barnes Defense
1160,1323,13,mate,white,163,B00,Barnes Defense
1930,1500,43,mate,white,430,B00,Barnes Defense
1233,1257,17,mate,white,24,B00,Barnes Defense
2222,1842,83,resign,white,380,B00,Barnes Defense
1689,1981,62,resign,white,292,A57,Benko Gambit
2104,2215,91,mate,white,111,A58,Benko Gambit Accepted |  Fianchetto Variation
2331,2336,83,resign,white,5,A57,Benko Gambit Declined |  Quiet Line
1833,1863,73,resign,white,30,A56,Benoni Defense
1661,1762,143,mate,white,101,A56,Benoni Defense
1880,1781,41,mate,white,99,A43,Benoni Defense: Benoni Gambit Accepted
1477,1492,59,resign,white,15,A43,Benoni Defense: Benoni Gambit Accepted
1682,1721,49,resign,white,39,A43,Benoni Defense: Benoni Gambit Accepted
1535,1500,13,resign,white,35,A43,Benoni Defense: Benoni Gambit Accepted
1874,2049,59,mate,white,175,A43,Benoni Defense: Benoni-Indian Defense
1724,1958,49,time,white,234,A43,Benoni Defense: Benoni-Indian Defense |  Kingside Move Order
1591,1581,67,time,white,10,A56,Benoni Defense: Czech Benoni Defense
1711,1757,55,resign,white,46,A60,Benoni Defense: Modern Variation
1795,1712,71,mate,white,83,A60,Benoni Defense: Modern Variation |  Snake Variation
1551,1500,105,resign,white,51,A43,Benoni Defense: Old Benoni
2329,2017,43,resign,white,312,A67,Benoni Defense: Taimanov Variation
2005,1969,45,resign,white,36,A02,Bird Opening
1481,1293,51,mate,white,188,A02,Bird Opening
1848,1186,25,resign,white,662,A02,Bird Opening
1922,1799,73,mate,white,123,A02,Bird Opening
1499,1315,39,resign,white,184,A02,Bird Opening
1500,1327,39,mate,white,173,A02,Bird Opening
1138,1104,89,mate,white,34,A02,Bird Opening
1741,1810,107,resign,white,69,A03,Bird Opening: Dutch Variation
1796,1709,149,time,white,87,A03,Bird Opening: Dutch Variation
1752,1441,50,resign,white,311,A03,Bird Opening: Dutch Variation
1462,1413,63,resign,white,49,A03,Bird Opening: Dutch Variation
1404,1357,59,resign,white,47,A03,Bird Opening: Dutch Variation
1455,1511,57,time,white,56,A03,Bird Opening: Dutch Variation
2066,1145,27,resign,white,921,A02,Bird Opening: From's Gambit
1190,949,53,mate,white,241,A02,Bird Opening: From's Gambit
1480,1643,27,resign,white,163,C23,Bishop's Opening
1649,1639,48,resign,white,10,C23,Bishop's Opening
1596,1711,41,mate,white,115,C23,Bishop's Opening
2173,1831,83,resign,white,342,C23,Bishop's Opening
1558,1526,64,resign,white,32,C23,Bishop's Opening
1964,1705,101,resign,white,259,C23,Bishop's Opening
1304,1318,53,mate,white,14,C23,Bishop's Opening
1429,1511,75,resign,white,82,C23,Bishop's Opening
1404,1197,81,mate,white,207,C23,Bishop's Opening
1500,1149,25,mate,white,351,C23,Bishop's Opening
995,1167,33,mate,white,172,C23,Bishop's Opening
1680,1299,45,mate,white,381,C23,Bishop's Opening
1053,1017,45,time,white,36,C23,Bishop's Opening
1473,1166,11,resign,white,307,C23,Bishop's Opening
1002,1534,13,mate,white,532,C23,Bishop's Opening
1379,1746,61,mate,white,367,C23,Bishop's Opening
1659,1268,7,mate,white,391,C23,Bishop's Opening
1445,1649,25,mate,white,204,C23,Bishop's Opening
1342,1075,25,resign,white,267,C23,Bishop's Opening
1916,2001,33,mate,white,85,C23,Bishop's Opening
1499,1468,99,time,white,31,C23,Bishop's Opening
1434,1357,31,time,white,77,C23,Bishop's Opening
1434,1442,109,mate,white,8,C23,Bishop's Opening
1796,1388,63,mate,white,408,C23,Bishop's Opening
1628,1402,85,resign,white,226,C23,Bishop's Opening
1683,1627,65,resign,white,56,C23,Bishop's Opening
1672,1663,64,resign,white,9,C23,Bishop's Opening
1346,1295,81,mate,white,51,C24,Bishop's Opening: Berlin Defense
1391,1411,69,resign,white,20,C24,Bishop's Opening: Berlin Defense
1396,1231,43,resign,white,165,C24,Bishop's Opening: Berlin Defense
1287,1089,49,mate,white,198,C24,Bishop's Opening: Berlin Defense
1153,1103,91,mate,white,50,C24,Bishop's Opening: Berlin Defense
1449,940,59,resign,white,509,C24,Bishop's Opening: Berlin Defense
2038,1957,73,mate,white,81,C24,Bishop's Opening: Berlin Defense
1227,1260,71,time,white,33,C24,Bishop's Opening: Berlin Defense
1731,1691,91,resign,white,40,C24,Bishop's Opening: Berlin Defense
1576,1390,15,mate,white,186,C24,Bishop's Opening: Berlin Defense
1985,1405,35,mate,white,580,C24,Bishop's Opening: Berlin Defense
1527,1357,112,resign,white,170,C24,Bishop's Opening: Berlin Defense
1646,1365,49,resign,white,281,C24,Bishop's Opening: Berlin Defense
1501,1496,123,mate,white,5,C24,Bishop's Opening: Berlin Defense
1453,1385,59,resign,white,68,C24,Bishop's Opening: Berlin Defense
1460,1402,46,resign,white,58,C24,Bishop's Opening: Berlin Defense
1413,1333,53,resign,white,80,C24,Bishop's Opening: Berlin Defense
1803,1562,33,resign,white,241,C24,Bishop's Opening: Berlin Defense
1819,1637,93,mate,white,182,C24,Bishop's Opening: Berlin Defense
1759,1767,151,mate,white,8,C24,Bishop's Opening: Berlin Defense
1737,1637,41,resign,white,100,C24,Bishop's Opening: Berlin Defense
1482,1460,65,resign,white,22,C24,Bishop's Opening: Berlin Defense
1353,1181,11,mate,white,172,C20,Bishop's Opening: Boi Variation
1840,1732,85,mate,white,108,C20,Bishop's Opening: Boi Variation
1146,1048,15,resign,white,98,C20,Bishop's Opening: Boi Variation
1802,1296,39,mate,white,506,C20,Bishop's Opening: Boi Variation
1476,1500,7,mate,white,24,C20,Bishop's Opening: Boi Variation
1582,1399,69,mate,white,183,C20,Bishop's Opening: Boi Variation
1515,1503,48,resign,white,12,C20,Bishop's Opening: Boi Variation
1557,1466,69,mate,white,91,C20,Bishop's Opening: Boi Variation
1501,1481,73,mate,white,20,C20,Bishop's Opening: Boi Variation
1798,1517,107,mate,white,281,C20,Bishop's Opening: Boi Variation
1733,1783,75,resign,white,50,C20,Bishop's Opening: Boi Variation
1479,1496,47,resign,white,17,C20,Bishop's Opening: Boi Variation
1368,1500,73,mate,white,132,C20,Bishop's Opening: Boi Variation
1900,1695,13,resign,white,205,C23,Bishop's Opening: Calabrese Countergambit
2003,1774,21,resign,white,229,C23,Bishop's Opening: Calabrese Countergambit
1290,1179,75,time,white,111,C23,Bishop's Opening: Khan Gambit
1430,1416,53,resign,white,14,C23,Bishop's Opening: Philidor Counterattack
1856,1045,13,mate,white,811,C23,Bishop's Opening: Philidor Counterattack
1131,1071,7,mate,white,60,C23,Bishop's Opening: Philidor Counterattack
1143,1191,115,mate,white,48,C24,Bishop's Opening: Ponziani Gambit
1698,1327,29,resign,white,371,C24,Bishop's Opening: Ponziani Gambit
1552,1334,55,resign,white,218,C24,Bishop's Opening: Ponziani Gambit
1984,1505,23,resign,white,479,C28,Bishop's Opening: Vienna Hybrid
2137,1939,53,resign,white,198,C26,Bishop's Opening: Vienna Hybrid |  Spielmann Attack
1696,1722,93,resign,white,26,D00,Blackmar-Diemer Gambit
1621,1605,115,mate,white,16,D00,Blackmar-Diemer Gambit
1515,1301,83,resign,white,214,D00,Blackmar-Diemer Gambit
1555,1361,77,resign,white,194,D00,Blackmar-Diemer Gambit
1500,1393,75,time,white,107,D00,Blackmar-Diemer Gambit Declined |  Weinsbach Declination
1878,1887,29,mate,white,9,D00,Blackmar-Diemer Gambit: Euwe Defense
1065,1073,55,resign,white,8,D00,Blackmar-Diemer Gambit: Gedult Gambit
1417,1271,46,resign,white,146,D00,Blackmar-Diemer Gambit: Netherlands Variation
1520,1423,33,resign,white,97,D00,Blackmar-Diemer Gambit: Pietrowsky Defense
1460,1296,45,mate,white,164,D00,Blackmar-Diemer Gambit: Pietrowsky Defense
1227,1303,51,resign,white,76,D00,Blackmar-Diemer Gambit: Ryder Gambit
1581,1657,83,time,white,76,D00,Blackmar-Diemer Gambit: Ryder Gambit
1569,978,28,resign,white,591,D00,Blackmar-Diemer Gambit: Tartakower Variation
1519,1556,39,mate,white,37,D00,Blackmar-Diemer Gambit: Teichmann Variation
2018,1908,43,resign,white,110,D00,Blackmar-Diemer Gambit: Teichmann Variation
1214,1115,53,resign,white,99,D00,Blackmar-Diemer Gambit: Zeller Defense
1518,1823,59,mate,white,305,D00,Blackmar-Diemer Gambit: Zeller Defense
1939,1581,25,resign,white,358,E10,Blumenfeld Countergambit #2
1789,1538,32,resign,white,251,E10,Blumenfeld Countergambit #2
1961,1930,64,resign,white,31,E10,Blumenfeld Countergambit #2
1550,1225,43,mate,white,325,E11,Bogo-Indian Defense: Exchange Variation
1194,1519,77,mate,white,325,B00,Borg Defense
1840,1580,82,resign,white,260,A52,Budapest Defense
1846,1845,59,resign,white,1,B10,Caro-Kann Defense
1288,1232,111,mate,white,56,B12,Caro-Kann Defense
1861,1863,51,resign,white,2,B11,Caro-Kann Defense
1860,1770,39,resign,white,90,B15,Caro-Kann Defense
1740,1500,77,mate,white,240,B10,Caro-Kann Defense
1197,1190,53,time,white,7,B10,Caro-Kann Defense
1685,1609,33,resign,white,76,B10,Caro-Kann Defense
1551,1276,25,mate,white,275,B15,Caro-Kann Defense
1251,1086,9,mate,white,165,B10,Caro-Kann Defense
1567,1632,85,resign,white,65,B10,Caro-Kann Defense
1306,1275,46,resign,white,31,B10,Caro-Kann Defense
1253,1236,38,resign,white,17,B10,Caro-Kann Defense
1231,1311,67,mate,white,80,B10,Caro-Kann Defense
1929,2046,87,resign,white,117,B12,Caro-Kann Defense
1695,1708,107,resign,white,13,B10,Caro-Kann Defense
2076,1450,39,resign,white,626,B15,Caro-Kann Defense
1222,1240,71,mate,white,18,B10,Caro-Kann Defense
1443,1152,36,resign,white,291,B10,Caro-Kann Defense
1349,1346,45,resign,white,3,B11,Caro-Kann Defense
1487,1685,53,mate,white,198,B10,Caro-Kann Defense
1514,1571,77,resign,white,57,B10,Caro-Kann Defense
1430,1581,81,resign,white,151,B12,Caro-Kann Defense
1560,1467,117,mate,white,93,B10,Caro-Kann Defense
1791,1677,109,resign,white,114,B10,Caro-Kann Defense
1829,1324,65,mate,white,505,B15,Caro-Kann Defense
1676,1325,51,resign,white,351,B10,Caro-Kann Defense
1774,1772,76,resign,white,2,B10,Caro-Kann Defense
1126,1094,31,time,white,32,B10,Caro-Kann Defense
1467,1305,33,resign,white,162,B10,Caro-Kann Defense
1515,1253,71,resign,white,262,B10,Caro-Kann Defense
1233,1289,49,resign,white,56,B15,Caro-Kann Defense
1542,1295,103,resign,white,247,B10,Caro-Kann Defense
1655,1286,79,resign,white,369,B10,Caro-Kann Defense
1353,1595,41,mate,white,242,B10,Caro-Kann Defense: Accelerated Panov Attack
1995,1905,55,resign,white,90,B10,Caro-Kann Defense: Accelerated Panov Attack |  Open Variation
1560,1419,38,resign,white,141,B12,Caro-Kann Defense: Advance Variation
1544,1528,55,resign,white,16,B12,Caro-Kann Defense: Advance Variation
1467,1594,75,resign,white,127,B12,Caro-Kann Defense: Advance Variation
1948,1864,60,resign,white,84,B12,Caro-Kann Defense: Advance Variation
1692,1730,125,resign,white,38,B12,Caro-Kann Defense: Advance Variation
1545,1550,45,time,white,5,B12,Caro-Kann Defense: Advance Variation
1773,1659,41,mate,white,114,B12,Caro-Kann Defense: Advance Variation |  Botvinnik-Carls Defense
1670,1243,45,resign,white,427,B12,Caro-Kann Defense: Advance Variation |  Botvinnik-Carls Defense
1335,1333,63,resign,white,2,B12,Caro-Kann Defense: Advance Variation |  Short Variation
1470,1625,49,resign,white,155,B12,Caro-Kann Defense: Advance Variation |  Short Variation
1690,1677,143,resign,white,13,B12,Caro-Kann Defense: Advance Variation |  Van der Wiel Attack
1437,1446,79,time,white,9,B15,Caro-Kann Defense: Alekhine Gambit
1345,1310,53,mate,white,35,B18,Caro-Kann Defense: Classical Variation
1705,1661,41,resign,white,44,B18,Caro-Kann Defense: Classical Variation
1362,1392,25,mate,white,30,B18,Caro-Kann Defense: Classical Variation
2298,2146,59,resign,white,152,B18,Caro-Kann Defense: Classical Variation
1635,1625,85,time,white,10,B18,Caro-Kann Defense: Classical Variation
2208,1944,51,time,white,264,B19,Caro-Kann Defense: Classical |  Spassky Variation
1612,1450,37,mate,white,162,B13,Caro-Kann Defense: Exchange Variation
2109,2247,66,resign,white,138,B13,Caro-Kann Defense: Exchange Variation
1876,1810,87,resign,white,66,B13,Caro-Kann Defense: Exchange Variation
1923,1258,41,mate,white,665,B13,Caro-Kann Defense: Exchange Variation
1916,1922,77,mate,white,6,B13,Caro-Kann Defense: Exchange Variation
1946,2211,83,mate,white,265,B13,Caro-Kann Defense: Exchange Variation
1354,1289,83,resign,white,65,B13,Caro-Kann Defense: Exchange Variation
2043,1981,45,resign,white,62,B13,Caro-Kann Defense: Exchange Variation
1480,1322,61,resign,white,158,B13,Caro-Kann Defense: Exchange Variation
1707,1703,45,resign,white,4,B13,Caro-Kann Defense: Exchange Variation
1617,1674,69,resign,white,57,B13,Caro-Kann Defense: Exchange Variation
1426,1178,37,mate,white,248,B15,Caro-Kann Defense: Gurgenidze System
1782,1268,39,resign,white,514,B00,Caro-Kann Defense: Hillbilly Attack
1753,1670,56,resign,white,83,B00,Caro-Kann Defense: Hillbilly Attack
1409,1173,11,mate,white,236,B00,Caro-Kann Defense: Hillbilly Attack
1230,1170,7,mate,white,60,B00,Caro-Kann Defense: Hillbilly Attack
1648,1682,131,resign,white,34,B00,Caro-Kann Defense: Hillbilly Attack
1668,1365,105,resign,white,303,B00,Caro-Kann Defense: Hillbilly Attack
1596,1341,97,resign,white,255,B00,Caro-Kann Defense: Hillbilly Attack
1342,1298,101,resign,white,44,B00,Caro-Kann Defense: Hillbilly Attack
1594,1545,45,mate,white,49,B17,Caro-Kann Defense: Karpov Variation
2275,2016,19,resign,white,259,B17,Caro-Kann Defense: Karpov Variation |  Tiviakov-Fischer Attack
1974,1653,43,resign,white,321,B15,Caro-Kann Defense: Main Line
2222,1810,37,mate,white,412,B12,Caro-Kann Defense: Maroczy Variation
1613,1934,99,resign,white,321,B12,Caro-Kann Defense: Maroczy Variation |  Maroczy Gambit
1718,1608,57,mate,white,110,B10,Caro-Kann Defense: Massachusetts Defense
2003,1284,43,mate,white,719,B12,Caro-Kann Defense: Modern Variation
1882,1873,51,time,white,9,B13,Caro-Kann Defense: Panov Attack |  Modern Defense |  Mieses Line
1946,1884,57,mate,white,62,B13,Caro-Kann Defense: Panov Attack |  Modern Defense |  Mieses Line
1955,1253,31,resign,white,702,B15,Caro-Kann Defense: Tartakower Variation
1909,1887,51,resign,white,22,B15,Caro-Kann Defense: Tartakower Variation
1799,1408,18,resign,white,391,B10,Caro-Kann Defense: Two Knights Attack
1327,1383,69,mate,white,56,B10,Caro-Kann Defense: Two Knights Attack
1810,1278,23,mate,white,532,B10,Caro-Kann Defense: Two Knights Attack
1282,1293,85,resign,white,11,B10,Caro-Kann Defense: Two Knights Attack
2016,1839,57,time,white,177,B10,Caro-Kann Defense: Two Knights Attack
1631,1710,71,resign,white,79,B10,Caro-Kann Defense: Two Knights Attack
1327,1425,83,mate,white,98,B10,Caro-Kann Defense: Two Knights Attack
1579,1497,167,mate,white,82,B11,Caro-Kann Defense: Two Knights Attack |  Mindeno Variation
1858,1436,59,resign,white,422,B11,Caro-Kann Defense: Two Knights Attack |  Mindeno Variation |  Exchange Line
1902,1830,38,resign,white,72,B11,Caro-Kann Defense: Two Knights Attack |  Mindeno Variation |  Retreat Line
1686,1782,101,resign,white,96,B00,Carr Defense
1847,1921,41,resign,white,74,E01,Catalan Opening
2084,1517,27,mate,white,567,E06,Catalan Opening: Closed Variation
1170,1179,45,resign,white,9,C21,Center Game
971,1153,46,resign,white,182,C21,Center Game
1093,1195,25,mate,white,102,C21,Center Game
1203,970,101,mate,white,233,C21,Center Game #2
1099,1198,7,time,white,99,C21,Center Game #2
1045,1080,3,time,white,35,C21,Center Game #2
1152,1159,27,resign,white,7,C21,Center Game #2
1491,1722,77,resign,white,231,C21,Center Game #2
1710,1274,81,mate,white,436,C21,Center Game #2
1392,1067,65,mate,white,325,C21,Center Game #2
1673,1464,81,mate,white,209,C21,Center Game #2
1490,1220,33,mate,white,270,C21,Center Game #2
1263,1343,91,mate,white,80,C21,Center Game #2
1679,1294,45,mate,white,385,C21,Center Game #2
1308,1317,51,mate,white,9,C22,Center Game: Berger Variation
1628,1341,57,mate,white,287,C22,Center Game: Berger Variation
1193,1362,53,resign,white,169,C22,Center Game: Berger Variation
1949,1879,59,mate,white,70,C21,Center Game: Kieseritzky Variation #2
1899,1780,41,mate,white,119,C21,Center Game: Kieseritzky Variation #4
1538,1721,75,resign,white,183,C21,Center Game: Kieseritzky Variation #4
1600,1300,71,mate,white,300,C22,Center Game: Normal Variation
1337,1523,85,time,white,186,C22,Center Game: Normal Variation
1466,1673,41,mate,white,207,C22,Center Game: Normal Variation
1386,1268,81,mate,white,118,C22,Center Game: Normal Variation
1218,1111,105,mate,white,107,D05,Colle System
1959,1839,71,resign,white,120,D05,Colle System
1240,958,83,mate,white,282,D05,Colle System #2
1516,1500,43,resign,white,16,D05,Colle System #2
1678,1148,15,mate,white,530,C21,Danish Gambit Accepted |  Classical Defense
1649,1445,91,mate,white,204,C21,Danish Gambit Accepted |  Copenhagen Defense
1550,1194,13,resign,white,356,B00,Duras Gambit
1480,1584,119,mate,white,104,B00,Duras Gambit
1389,1525,53,resign,white,136,B00,Duras Gambit
1653,1522,29,resign,white,131,A80,Dutch Defense
1337,1458,45,resign,white,121,A80,Dutch Defense
1348,1291,125,mate,white,57,A80,Dutch Defense
1593,1503,49,resign,white,90,A84,Dutch Defense
1281,1286,58,resign,white,5,A80,Dutch Defense
2217,2059,49,resign,white,158,A99,Dutch Defense: Classical Variation |  Ilyin-Zhenevsky Variation |  Modern Main Line
1500,1973,75,mate,white,473,A80,Dutch Defense: Hopton Attack
2440,2081,42,resign,white,359,A97,Dutch Defense: Ilyin-Zhenevsky |  Winter Variation
1861,1398,19,resign,white,463,A84,Dutch Defense: Normal Variation
1574,1510,43,mate,white,64,A80,Dutch Defense: Omega-Isis Gambit
1554,1530,47,mate,white,24,A80,Dutch Defense: Omega-Isis Gambit
1894,1775,67,resign,white,119,A85,Dutch Defense: Queen's Knight Variation
1791,1929,91,mate,white,138,A85,Dutch Defense: Queen's Knight Variation
1458,1363,26,resign,white,95,A85,Dutch Defense: Queen's Knight Variation
2153,2148,85,resign,white,5,A85,Dutch Defense: Queen's Knight Variation
1654,1573,25,resign,white,81,A85,Dutch Defense: Queen's Knight Variation
1966,2056,65,resign,white,90,A85,Dutch Defense: Queen's Knight Variation
2108,1500,49,mate,white,608,A80,Dutch Defense: Raphael Variation
2220,2157,57,resign,white,63,A84,Dutch Defense: Rubinstein Variation
2013,1823,43,resign,white,190,A84,Dutch Defense: Rubinstein Variation
1383,1410,41,resign,white,27,A49,East Indian Defense
1919,1949,38,resign,white,30,A49,East Indian Defense
1612,1506,61,mate,white,106,A49,East Indian Defense
1517,1320,17,resign,white,197,C40,Elephant Gambit
1262,1240,115,mate,white,22,C40,Elephant Gambit
1133,1264,29,resign,white,131,C40,Elephant Gambit
1279,1036,13,resign,white,243,C40,Elephant Gambit
1383,1307,47,mate,white,76,C40,Elephant Gambit
1375,1346,35,resign,white,29,C40,Elephant Gambit
1398,1355,9,resign,white,43,C40,Elephant Gambit
1297,1413,39,mate,white,116,C40,Elephant Gambit
1251,1314,65,mate,white,63,C40,Elephant Gambit
1794,1597,51,resign,white,197,C40,Elephant Gambit
1585,1045,79,mate,white,540,C40,Elephant Gambit
1662,1220,47,resign,white,442,C40,Elephant Gambit
1541,1277,9,resign,white,264,C40,Elephant Gambit
1738,1025,31,mate,white,713,C40,Elephant Gambit
1374,1687,41,mate,white,313,C40,Elephant Gambit
1123,1084,61,mate,white,39,C40,Elephant Gambit: Paulsen Countergambit
1314,1295,101,mate,white,19,C40,Elephant Gambit: Paulsen Countergambit
1667,1708,37,mate,white,41,C40,Elephant Gambit: Paulsen Countergambit
1807,1690,35,time,white,117,A40,English Defense
1677,1460,101,mate,white,217,A40,English Defense
1340,1326,44,resign,white,14,A40,English Defense #2
1676,1684,34,resign,white,8,A40,English Defense #2
1771,1875,97,mate,white,104,A40,English Defense #2
1615,1500,41,mate,white,115,A40,English Defense #2
1846,1834,49,resign,white,12,A40,English Defense #2
1080,1047,33,time,white,33,A40,English Defense #2
1778,1484,43,mate,white,294,A40,English Defense #2
1573,1566,55,mate,white,7,A40,English Defense #2
1215,1316,69,time,white,101,A40,English Defense #2
1529,1500,33,mate,white,29,A40,English Defense #2
1590,1388,3,resign,white,202,A10,English Opening
1728,1441,61,resign,white,287,A10,English Opening
1690,1371,89,resign,white,319,A10,English Opening
1951,1894,119,resign,white,57,A10,English Opening
1741,1496,41,mate,white,245,A13,English Opening: Agincourt Defense
1573,1590,16,resign,white,17,A13,English Opening: Agincourt Defense
1497,1494,75,resign,white,3,A13,English Opening: Agincourt Defense
1724,1770,21,resign,white,46,A13,English Opening: Agincourt Defense
1853,1748,44,resign,white,105,A13,English Opening: Agincourt Defense
1360,1362,27,time,white,2,A13,English Opening: Agincourt Defense #2
2326,1907,55,resign,white,419,A13,English Opening: Agincourt Defense #2
1437,1418,57,mate,white,19,A13,English Opening: Agincourt Defense #3
2432,2090,37,resign,white,342,A13,English Opening: Agincourt Defense #3
1375,1408,35,mate,white,33,A16,English Opening: Anglo-Gruenfeld Defense
1752,1677,85,resign,white,75,A15,English Opening: Anglo-Indian Defense
1586,1623,59,resign,white,37,A15,English Opening: Anglo-Indian Defense
1457,1449,111,mate,white,8,A15,English Opening: Anglo-Indian Defense
1666,1553,51,resign,white,113,A15,English Opening: Anglo-Indian Defense
1734,1714,61,resign,white,20,A15,English Opening: Anglo-Indian Defense
1704,1770,83,time,white,66,A15,English Opening: Anglo-Indian Defense
1798,1780,45,resign,white,18,A15,English Opening: Anglo-Indian Defense
1797,2083,71,time,white,286,A15,English Opening: Anglo-Indian Defense |  King's Indian Formation
1278,946,47,mate,white,332,A15,English Opening: Anglo-Indian Defense |  King's Knight Variation
2041,1876,61,mate,white,165,A15,English Opening: Anglo-Indian Defense |  Queen's Indian Formation
1886,1862,59,resign,white,24,A16,English Opening: Anglo-Indian Defense |  Queen's Knight Variation
2032,1961,140,resign,white,71,A16,English Opening: Anglo-Indian Defense |  Queen's Knight Variation
1962,2219,59,mate,white,257,A15,English Opening: Anglo-Indian Defense |  Scandinavian Defense
2176,2001,25,resign,white,175,A15,English Opening: Anglo-Indian Defense |  Scandinavian Defense |  Exchange Variation
2264,1946,79,resign,white,318,A15,English Opening: Anglo-Indian Defense |  Scandinavian Defense |  Exchange Variation
1521,1549,51,resign,white,28,A10,English Opening: Anglo-Lithuanian Variation
911,1356,125,mate,white,445,A10,English Opening: Anglo-Lithuanian Variation
1807,1798,45,resign,white,9,A10,English Opening: Anglo-Lithuanian Variation
1315,1122,37,mate,white,193,A10,English Opening: Anglo-Lithuanian Variation
1451,1514,91,mate,white,63,A10,English Opening: Anglo-Lithuanian Variation
1748,1216,25,mate,white,532,A10,English Opening: Anglo-Lithuanian Variation
1989,1987,21,resign,white,2,A10,English Opening: Anglo-Lithuanian Variation
1577,1618,41,mate,white,41,A10,English Opening: Anglo-Scandinavian Defense
1412,1337,87,mate,white,75,A10,English Opening: Anglo-Scandinavian Defense
1181,978,13,resign,white,203,A10,English Opening: Anglo-Scandinavian Defense
1256,1163,35,resign,white,93,A10,English Opening: Anglo-Scandinavian Defense
1491,1505,64,resign,white,14,A10,English Opening: Anglo-Scandinavian Defense
1467,1404,51,resign,white,63,A10,English Opening: Anglo-Scandinavian Defense
1462,1545,17,resign,white,83,A10,English Opening: Anglo-Scandinavian Defense
1457,1550,29,mate,white,93,A10,English Opening: Anglo-Scandinavian Defense
1488,1466,79,resign,white,22,A10,English Opening: Anglo-Scandinavian Defense
1690,1365,129,resign,white,325,A10,English Opening: Anglo-Scandinavian Defense
1753,1335,49,time,white,418,A10,English Opening: Anglo-Scandinavian Defense
1375,1333,71,time,white,42,A10,English Opening: Anglo-Scandinavian Defense
1302,1585,16,resign,white,283,A10,English Opening: Anglo-Scandinavian Defense
1590,1600,135,mate,white,10,A22,English Opening: Carls-Bremen System
2210,1982,77,resign,white,228,A22,English Opening: Carls-Bremen System
2021,1844,39,resign,white,177,A22,English Opening: Carls-Bremen System
2039,2011,65,resign,white,28,A22,English Opening: Carls-Bremen System
1919,1488,31,mate,white,431,A11,English Opening: Caro-Kann Defensive System
1699,1497,29,time,white,202,A11,English Opening: Caro-Kann Defensive System
2008,1744,87,resign,white,264,A11,English Opening: Caro-Kann Defensive System
1688,1704,40,resign,white,16,A10,English Opening: Great Snake Variation
1402,1495,62,resign,white,93,A10,English Opening: Great Snake Variation
1466,1395,11,resign,white,71,A10,English Opening: Great Snake Variation
2264,1838,41,resign,white,426,A10,English Opening: Great Snake Variation
1316,1273,85,mate,white,43,A20,English Opening: King's English Variation
1779,1794,161,resign,white,15,A20,English Opening: King's English Variation
1419,1544,49,time,white,125,A20,English Opening: King's English Variation
1639,1807,45,mate,white,168,A20,English Opening: King's English Variation
1355,1352,35,mate,white,3,A20,English Opening: King's English Variation
1355,1431,14,resign,white,76,A20,English Opening: King's English Variation
2285,2173,59,resign,white,112,A20,English Opening: King's English Variation
1476,1432,37,resign,white,44,A20,English Opening: King's English Variation
1480,1592,39,resign,white,112,A20,English Opening: King's English Variation
1476,1469,97,mate,white,7,A20,English Opening: King's English Variation
2023,1168,51,mate,white,855,A20,English Opening: King's English Variation
1784,1871,75,resign,white,87,A20,English Opening: King's English Variation
2095,1991,91,time,white,104,A20,English Opening: King's English Variation
2088,1974,125,mate,white,114,A20,English Opening: King's English Variation
1722,1773,41,resign,white,51,A20,English Opening: King's English Variation
1746,1745,47,mate,white,1,A20,English Opening: King's English Variation
1549,1536,43,resign,white,13,A20,English Opening: King's English Variation
1744,1174,51,mate,white,570,A20,English Opening: King's English Variation
1973,1808,69,time,white,165,A20,English Opening: King's English Variation
2229,2134,49,resign,white,95,A21,English Opening: King's English Variation
1382,1406,39,mate,white,24,A20,English Opening: King's English Variation
1405,1403,39,mate,white,2,A20,English Opening: King's English Variation
1171,1432,59,mate,white,261,A29,English Opening: King's English Variation |  Four Knights Variation |  Fianchetto Line
1171,1432,59,mate,white,261,A29,English Opening: King's English Variation |  Four Knights Variation |  Fianchetto Line
1939,2177,47,resign,white,238,A29,English Opening: King's English Variation |  Four Knights Variation |  Fianchetto Line
2183,1551,101,resign,white,632,A29,English Opening: King's English Variation |  Four Knights Variation |  Fianchetto Line
2251,2006,54,resign,white,245,A29,English Opening: King's English Variation |  Four Knights Variation |  Fianchetto Line
1104,1168,17,resign,white,64,A28,English Opening: King's English Variation |  Four Knights Variation |  Quiet Line #3
2262,2037,7,resign,white,225,A28,English Opening: King's English Variation |  Four Knights Variation |  Quiet Line #3
1307,1106,36,resign,white,201,A25,English Opening: King's English Variation |  Reversed Closed Sicilian
1315,1264,19,resign,white,51,A25,English Opening: King's English Variation |  Reversed Closed Sicilian
1594,1750,33,mate,white,156,A25,English Opening: King's English Variation |  Reversed Closed Sicilian
1542,1659,51,time,white,117,A25,English Opening: King's English Variation |  Reversed Closed Sicilian
1751,1287,75,resign,white,464,A25,English Opening: King's English Variation |  Reversed Closed Sicilian
1545,1559,93,mate,white,14,A21,English Opening: King's English Variation |  Reversed Sicilian
1878,1043,73,mate,white,835,A21,English Opening: King's English Variation |  Reversed Sicilian
1502,1500,85,mate,white,2,A21,English Opening: King's English Variation |  Reversed Sicilian
1494,1589,23,resign,white,95,A21,English Opening: King's English Variation |  Reversed Sicilian
1506,1505,38,resign,white,1,A21,English Opening: King's English Variation |  Reversed Sicilian
1466,1503,111,resign,white,37,A21,English Opening: King's English Variation |  Reversed Sicilian
1588,1706,57,resign,white,118,A21,English Opening: King's English Variation |  Reversed Sicilian
2050,1807,35,resign,white,243,A21,English Opening: King's English Variation |  Reversed Sicilian
2011,1978,67,resign,white,33,A21,English Opening: King's English Variation |  Reversed Sicilian
1575,1571,69,resign,white,4,A27,English Opening: King's English Variation |  Three Knights System
1494,1364,61,mate,white,130,A27,English Opening: King's English Variation |  Three Knights System
1950,1835,57,mate,white,115,A27,English Opening: King's English Variation |  Three Knights System
1539,1500,45,mate,white,39,A27,English Opening: King's English Variation |  Three Knights System
1217,1399,23,resign,white,182,A22,English Opening: King's English Variation |  Two Knights Variation
1127,1234,23,mate,white,107,A22,English Opening: King's English Variation |  Two Knights Variation
1468,1386,111,mate,white,82,A22,English Opening: King's English Variation |  Two Knights Variation
1659,1543,49,resign,white,116,A22,English Opening: King's English Variation |  Two Knights Variation
1775,1801,91,resign,white,26,A22,English Opening: King's English Variation |  Two Knights Variation
2018,1988,28,resign,white,30,A23,English Opening: King's English Variation |  Two Knights Variation |  Keres Variation
1467,1468,79,resign,white,1,A22,English Opening: King's English Variation |  Two Knights Variation |  Smyslov System
2202,2008,119,mate,white,194,A18,English Opening: Mikenas-Carls Variation #2
1363,1250,113,resign,white,113,A30,English Opening: Symmetrical Variation
1240,1012,93,mate,white,228,A30,English Opening: Symmetrical Variation
1505,1393,69,resign,white,112,A30,English Opening: Symmetrical Variation
1102,1301,26,resign,white,199,A30,English Opening: Symmetrical Variation
1894,1961,43,resign,white,67,A30,English Opening: Symmetrical Variation
1661,1661,39,resign,white,0,A30,English Opening: Symmetrical Variation
1516,1173,27,mate,white,343,A30,English Opening: Symmetrical Variation
2028,1981,73,resign,white,47,A30,English Opening: Symmetrical Variation
1984,2052,106,resign,white,68,A36,English Opening: Symmetrical Variation |  Botvinnik System Reversed
1737,1408,57,resign,white,329,A38,English Opening: Symmetrical Variation |  Duchamp Variation
2030,1937,55,resign,white,93,A36,English Opening: Symmetrical Variation |  Fianchetto Variation
2203,1718,37,resign,white,485,A35,English Opening: Symmetrical Variation |  Four Knights Variation
1864,2267,45,resign,white,403,A39,English Opening: Symmetrical Variation |  Mecking Variation
1982,1917,33,resign,white,65,A34,English Opening: Symmetrical Variation |  Normal Variation
1423,1479,113,mate,white,56,A34,English Opening: Symmetrical Variation |  Normal Variation
1199,1054,63,mate,white,145,A34,English Opening: Symmetrical Variation |  Normal Variation
1487,1457,77,resign,white,30,A34,English Opening: Symmetrical Variation |  Normal Variation
1461,1388,55,mate,white,73,A34,English Opening: Symmetrical Variation |  Normal Variation
2198,1500,39,resign,white,698,A34,English Opening: Symmetrical Variation |  Normal Variation
1696,1344,25,resign,white,352,C20,English Opening: The Whale
1406,1496,51,resign,white,90,C20,English Opening: The Whale
1660,1685,137,mate,white,25,C20,English Opening: The Whale
1295,1321,45,resign,white,26,A40,Englund Gambit
1635,1647,15,time,white,12,A40,Englund Gambit
1436,1345,59,mate,white,91,A40,Englund Gambit
1720,1334,60,resign,white,386,A40,Englund Gambit
1625,1257,23,mate,white,368,A40,Englund Gambit
1465,1500,119,mate,white,35,A40,Englund Gambit
1549,1344,7,time,white,205,A40,Englund Gambit
1431,1750,61,time,white,319,A40,Englund Gambit Complex Declined
1900,1794,113,resign,white,106,A40,Englund Gambit Complex: Englund Gambit
1901,1097,25,resign,white,804,A40,Englund Gambit Complex: Felbecker Gambit
1738,1623,39,resign,white,115,A40,Englund Gambit Complex: Hartlaub-Charlick Gambit
1249,1233,105,mate,white,16,A40,Englund Gambit Complex: Soller Gambit
1500,1041,39,mate,white,459,A40,Englund Gambit Complex: Soller Gambit
2344,1898,51,resign,white,446,A40,Englund Gambit Complex: Soller Gambit
1403,1340,23,resign,white,63,A40,Englund Gambit Declined |  Reversed French
1011,1184,57,mate,white,173,A40,Englund Gambit Declined |  Reversed French
906,1001,41,time,white,95,A40,Englund Gambit Declined |  Reversed French
1765,1846,135,mate,white,81,A40,Englund Gambit Declined |  Reversed French
1365,1313,131,resign,white,52,A40,Englund Gambit Declined |  Reversed French
1286,1067,9,mate,white,219,A40,Englund Gambit Declined |  Reversed French
1399,1273,49,resign,white,126,A40,Englund Gambit Declined |  Reversed French
1500,1358,97,time,white,142,C46,Four Knights Game
1278,1380,51,mate,white,102,C46,Four Knights Game
1561,1163,85,resign,white,398,C46,Four Knights Game
1606,1594,109,mate,white,12,C46,Four Knights Game
1697,1378,55,mate,white,319,C46,Four Knights Game
1517,1567,99,mate,white,50,C46,Four Knights Game
1500,1403,67,resign,white,97,C49,Four Knights Game: Double Spanish
1531,1593,83,resign,white,62,C46,Four Knights Game: Gunsberg Variation
990,1452,147,resign,white,462,C46,Four Knights Game: Gunsberg Variation
1694,1329,51,resign,white,365,C46,Four Knights Game: Gunsberg Variation
1661,1677,45,resign,white,16,C46,Four Knights Game: Gunsberg Variation
1227,1227,30,resign,white,0,C50,Four Knights Game: Italian Variation
1289,1306,15,resign,white,17,C50,Four Knights Game: Italian Variation
1313,1360,97,mate,white,47,C46,Four Knights Game: Italian Variation
1349,1419,39,mate,white,70,C46,Four Knights Game: Italian Variation
1347,1186,111,mate,white,161,C46,Four Knights Game: Italian Variation
1383,1286,63,mate,white,97,C46,Four Knights Game: Italian Variation
1279,1625,51,resign,white,346,C46,Four Knights Game: Italian Variation
1605,1517,55,resign,white,88,C50,Four Knights Game: Italian Variation
1271,1328,77,resign,white,57,C50,Four Knights Game: Italian Variation
1397,940,27,mate,white,457,C46,Four Knights Game: Italian Variation
1336,1468,51,resign,white,132,C50,Four Knights Game: Italian Variation
1184,1269,53,mate,white,85,C46,Four Knights Game: Italian Variation
1196,1162,39,mate,white,34,C50,Four Knights Game: Italian Variation
1817,1798,107,time,white,19,C46,Four Knights Game: Italian Variation
1446,1317,49,mate,white,129,C46,Four Knights Game: Italian Variation
1259,1472,35,resign,white,213,C46,Four Knights Game: Italian Variation
1575,1527,131,mate,white,48,C46,Four Knights Game: Italian Variation
1518,1410,39,mate,white,108,C46,Four Knights Game: Italian Variation
1242,1176,20,resign,white,66,C46,Four Knights Game: Italian Variation
1620,1651,15,time,white,31,C46,Four Knights Game: Italian Variation
1227,1191,109,mate,white,36,C46,Four Knights Game: Italian Variation
1172,1329,85,mate,white,157,C50,Four Knights Game: Italian Variation
1618,1652,43,mate,white,34,C50,Four Knights Game: Italian Variation
1195,1002,95,resign,white,193,C50,Four Knights Game: Italian Variation
1322,1142,7,resign,white,180,C46,Four Knights Game: Italian Variation
1595,1539,47,mate,white,56,C46,Four Knights Game: Italian Variation
1249,1147,25,mate,white,102,C46,Four Knights Game: Italian Variation
1524,1358,63,resign,white,166,C50,Four Knights Game: Italian Variation
1348,1272,81,time,white,76,C46,Four Knights Game: Italian Variation
1640,1346,55,resign,white,294,C46,Four Knights Game: Italian Variation
2012,2074,55,resign,white,62,C46,Four Knights Game: Italian Variation
1535,1528,63,resign,white,7,C46,Four Knights Game: Italian Variation
1477,1483,56,resign,white,6,C50,Four Knights Game: Italian Variation
1619,1017,81,resign,white,602,C46,Four Knights Game: Italian Variation
1886,1688,60,resign,white,198,C46,Four Knights Game: Italian Variation
2037,1677,25,resign,white,360,C46,Four Knights Game: Italian Variation
1748,1671,77,time,white,77,C48,Four Knights Game: Ranken Variation
1316,1301,23,resign,white,15,C48,Four Knights Game: Ranken Variation
1343,1326,63,resign,white,17,C48,Four Knights Game: Ranken Variation
1866,1258,45,resign,white,608,C48,Four Knights Game: Rubinstein Countergambit |  Henneberger Variation
1206,1163,48,resign,white,43,C47,Four Knights Game: Scotch Variation
1584,1545,37,mate,white,39,C47,Four Knights Game: Scotch Variation
1537,1504,46,resign,white,33,C47,Four Knights Game: Scotch Variation
1701,1821,71,time,white,120,C47,Four Knights Game: Scotch Variation
1301,1394,11,resign,white,93,C47,Four Knights Game: Scotch Variation
991,1084,43,resign,white,93,C47,Four Knights Game: Scotch Variation
1382,1388,81,mate,white,6,C47,Four Knights Game: Scotch Variation Accepted
1346,1386,31,mate,white,40,C47,Four Knights Game: Scotch Variation Accepted
1257,1192,45,mate,white,65,C47,Four Knights Game: Scotch Variation Accepted
1872,1919,73,resign,white,47,C47,Four Knights Game: Scotch Variation Accepted
1111,1219,65,mate,white,108,C48,Four Knights Game: Spanish Variation
1066,1326,61,mate,white,260,C48,Four Knights Game: Spanish Variation
1194,1308,75,mate,white,114,C48,Four Knights Game: Spanish Variation
1704,1775,43,resign,white,71,C48,Four Knights Game: Spanish Variation
1699,1800,41,resign,white,101,C48,Four Knights Game: Spanish Variation
1411,1431,83,mate,white,20,C48,Four Knights Game: Spanish Variation
1434,1179,87,resign,white,255,C48,Four Knights Game: Spanish Variation
1438,1484,57,mate,white,46,C48,Four Knights Game: Spanish Variation
1547,1518,61,mate,white,29,C48,Four Knights Game: Spanish Variation
1526,1445,68,resign,white,81,C48,Four Knights Game: Spanish Variation
1724,1561,81,resign,white,163,C48,Four Knights Game: Spanish Variation
1604,1614,89,resign,white,10,C48,Four Knights Game: Spanish Variation |  Classical Variation
2014,1827,75,time,white,187,C48,Four Knights Game: Spanish Variation |  Classical Variation
1225,1252,59,mate,white,27,C48,Four Knights Game: Spanish Variation |  Classical Variation
1620,1549,127,resign,white,71,C48,Four Knights Game: Spanish Variation |  Classical Variation
1257,1362,45,mate,white,105,C48,Four Knights Game: Spanish Variation |  Classical Variation
1822,1662,22,resign,white,160,C48,Four Knights Game: Spanish Variation |  Classical Variation
1341,1056,59,mate,white,285,C48,Four Knights Game: Spanish Variation |  Rubinstein Variation Accepted
1714,1709,65,resign,white,5,A43,Franco-Benoni Defense
1868,1656,103,time,white,212,A43,Franco-Benoni Defense
2011,2004,43,mate,white,7,A43,Franco-Benoni Defense
1459,1515,71,resign,white,56,A43,Franco-Benoni Defense
1107,977,61,mate,white,130,C00,French Defense
1374,1115,9,time,white,259,C00,French Defense
1723,1859,55,resign,white,136,C00,French Defense #2
1412,1401,105,mate,white,11,C00,French Defense #2
1307,1033,35,mate,white,274,C00,French Defense #2
983,1051,43,resign,white,68,C00,French Defense #2
1111,1198,97,resign,white,87,C00,French Defense #2
1148,1165,62,resign,white,17,C00,French Defense #2
1241,1112,79,mate,white,129,C00,French Defense #2
1825,1074,53,mate,white,751,C00,French Defense #2
1344,1313,85,resign,white,31,C00,French Defense #2
1782,1864,100,resign,white,82,C00,French Defense #2
2048,1875,37,resign,white,173,C00,French Defense #2
1746,1403,63,mate,white,343,C00,French Defense #2
1315,1239,49,resign,white,76,C00,French Defense #2
1684,2239,101,time,white,555,C00,French Defense #2
1479,1344,91,mate,white,135,C00,French Defense #2
1519,1495,51,mate,white,24,C00,French Defense #2
1342,1553,11,resign,white,211,C00,French Defense #2
1708,1729,61,resign,white,21,C02,French Defense: Advance Variation
1586,1607,131,mate,white,21,C02,French Defense: Advance Variation
1514,1528,42,resign,white,14,C02,French Defense: Advance Variation
1175,1270,65,resign,white,95,C02,French Defense: Advance Variation #2
1526,1525,73,resign,white,1,C02,French Defense: Advance Variation #2
1604,1489,65,mate,white,115,C02,French Defense: Advance Variation #2
1165,1127,37,mate,white,38,C02,French Defense: Advance Variation #2
1214,925,73,resign,white,289,C02,French Defense: Advance Variation #3
1227,1254,51,resign,white,27,C02,French Defense: Advance Variation #3
1576,1587,29,resign,white,11,C02,French Defense: Advance Variation #3
1348,1160,51,mate,white,188,C02,French Defense: Advance Variation #3
1539,1136,38,resign,white,403,C02,French Defense: Advance Variation #3
1455,1427,16,resign,white,28,C02,French Defense: Advance Variation #3
1707,1093,47,resign,white,614,C02,French Defense: Advance Variation #3
1226,1230,75,resign,white,4,C02,French Defense: Advance Variation #3
1327,1322,61,mate,white,5,C02,French Defense: Advance Variation #3
1789,1258,35,resign,white,531,C02,French Defense: Advance Variation #3
1461,1444,28,resign,white,17,C02,French Defense: Advance Variation #3
1340,1203,15,time,white,137,C02,French Defense: Advance Variation #3
1545,1616,129,mate,white,71,C02,French Defense: Advance Variation #3
1309,1336,63,mate,white,27,C02,French Defense: Advance Variation #4
1253,1471,29,mate,white,218,C02,French Defense: Advance Variation #4
1636,1633,51,mate,white,3,C02,French Defense: Advance Variation #4
2229,2002,63,mate,white,227,C02,French Defense: Advance Variation |  Euwe Variation
1866,1734,63,resign,white,132,C02,French Defense: Advance Variation |  Euwe Variation
1517,1512,66,resign,white,5,C02,French Defense: Advance Variation |  Euwe Variation
1761,1700,31,resign,white,61,C02,French Defense: Advance Variation |  Euwe Variation
1951,1729,135,mate,white,222,C02,French Defense: Advance Variation |  Main Line
1833,1738,127,time,white,95,C02,French Defense: Advance Variation |  Main Line
1503,1819,71,mate,white,316,C02,French Defense: Advance Variation |  Main Line
1502,1590,65,resign,white,88,C02,French Defense: Advance Variation |  Main Line
1221,1417,37,mate,white,196,C02,French Defense: Advance Variation |  Milner-Barry Gambit
2063,1633,105,mate,white,430,C02,French Defense: Advance Variation |  Milner-Barry Gambit
1713,1885,45,resign,white,172,C02,French Defense: Advance Variation |  Milner-Barry Gambit
1898,1719,99,resign,white,179,C02,French Defense: Advance Variation |  Milner-Barry Gambit
2199,1843,121,mate,white,356,C02,French Defense: Advance Variation |  Nimzowitsch Attack
1550,1482,40,resign,white,68,C02,French Defense: Advance Variation |  Nimzowitsch System
1464,1496,82,resign,white,32,C02,French Defense: Advance Variation |  Nimzowitsch System
1334,1341,66,resign,white,7,C02,French Defense: Advance Variation |  Nimzowitsch System
1561,1493,43,resign,white,68,C02,French Defense: Advance Variation |  Nimzowitsch System
1613,1729,71,resign,white,116,C02,French Defense: Advance Variation |  Paulsen Attack
2272,2061,39,resign,white,211,C02,French Defense: Advance Variation |  Paulsen Attack
1868,1991,51,resign,white,123,C02,French Defense: Advance Variation |  Paulsen Attack
1556,1264,47,mate,white,292,C02,French Defense: Advance Variation |  Paulsen Attack
1726,1709,61,resign,white,17,C02,French Defense: Advance Variation |  Paulsen Attack
1648,1665,79,resign,white,17,C02,French Defense: Advance Variation |  Paulsen Attack
1561,1567,37,resign,white,6,C02,French Defense: Advance Variation |  Paulsen Attack
1546,1601,35,resign,white,55,C02,French Defense: Advance Variation |  Paulsen Attack
1755,1630,51,resign,white,125,C02,French Defense: Advance Variation |  Paulsen Attack
1629,1611,49,resign,white,18,C02,French Defense: Advance Variation |  Paulsen Attack
1548,1567,55,mate,white,19,C02,French Defense: Advance Variation |  Paulsen Attack
1936,1930,38,resign,white,6,C11,French Defense: Burn Variation
1840,1699,123,resign,white,141,C01,French Defense: Carlson Gambit
1720,1579,48,resign,white,141,C00,French Defense: Chigorin Variation
2147,2120,81,resign,white,27,C00,French Defense: Chigorin Variation
2270,1613,49,resign,white,657,C00,French Defense: Chigorin Variation
1062,1216,49,time,white,154,C11,French Defense: Classical Variation
1949,1863,38,resign,white,86,C14,French Defense: Classical Variation |  Alapin Variation
1799,1843,71,resign,white,44,C14,French Defense: Classical Variation |  Pollock Variation
1855,1599,37,resign,white,256,C01,French Defense: Exchange Variation
1382,1414,125,mate,white,32,C01,French Defense: Exchange Variation
1937,2090,129,time,white,153,C01,French Defense: Exchange Variation
1951,1664,25,resign,white,287,C01,French Defense: Exchange Variation
1803,1737,63,resign,white,66,C01,French Defense: Exchange Variation
1726,1589,27,resign,white,137,C01,French Defense: Exchange Variation
2264,1529,45,resign,white,735,C01,French Defense: Exchange Variation
1857,1590,43,resign,white,267,C01,French Defense: Exchange Variation
1727,1625,55,mate,white,102,C01,French Defense: Exchange Variation
1785,2054,29,resign,white,269,C01,French Defense: Exchange Variation
1425,1576,33,resign,white,151,C01,French Defense: Exchange Variation
1793,1076,39,resign,white,717,C01,French Defense: Exchange Variation
1703,1484,41,time,white,219,C01,French Defense: Exchange Variation
1426,1178,115,time,white,248,C01,French Defense: Exchange Variation
2182,1809,77,resign,white,373,C01,French Defense: Exchange Variation
1476,1131,73,resign,white,345,C01,French Defense: Exchange Variation
2269,2347,77,resign,white,78,C01,French Defense: Exchange Variation
1621,1268,63,resign,white,353,C01,French Defense: Exchange Variation
1699,1812,65,mate,white,113,C01,French Defense: Exchange Variation
1881,1810,99,resign,white,71,C01,French Defense: Exchange Variation
1708,1652,71,resign,white,56,C01,French Defense: Exchange Variation
1806,1823,143,mate,white,17,C01,French Defense: Exchange Variation
2191,2041,65,time,white,150,C01,French Defense: Exchange Variation
1393,1427,63,mate,white,34,C01,French Defense: Exchange Variation
1812,1575,69,resign,white,237,C01,French Defense: Exchange Variation
1716,1732,75,resign,white,16,C01,French Defense: Exchange Variation
2021,1759,45,resign,white,262,C01,French Defense: Exchange Variation
1905,1738,61,resign,white,167,C01,French Defense: Exchange Variation
1678,1785,33,resign,white,107,C01,French Defense: Exchange Variation
1963,1942,57,resign,white,21,C01,French Defense: Exchange Variation |  Monte Carlo Variation
2009,2058,58,resign,white,49,C01,French Defense: Exchange Variation |  Monte Carlo Variation
1574,1569,51,mate,white,5,C01,French Defense: Franco-Hiva Gambit I
1884,1809,41,resign,white,75,C00,French Defense: Horwitz Attack
2150,1829,141,mate,white,321,C00,French Defense: King's Indian Attack
1046,1096,39,resign,white,50,C00,French Defense: King's Indian Attack
1200,1257,21,resign,white,57,C00,French Defense: King's Indian Attack
1262,1184,53,mate,white,78,C00,French Defense: King's Indian Attack
1908,1821,76,resign,white,87,C00,French Defense: King's Indian Attack
1039,1070,67,resign,white,31,C00,French Defense: King's Indian Attack
1851,1890,59,resign,white,39,C00,French Defense: Knight Variation
1559,1557,97,mate,white,2,C00,French Defense: Knight Variation
1529,1639,38,resign,white,110,C00,French Defense: Knight Variation
1582,1704,41,resign,white,122,C00,French Defense: Knight Variation
1603,1594,49,mate,white,9,C00,French Defense: Knight Variation
1834,1856,47,resign,white,22,C00,French Defense: Knight Variation
1334,1400,27,mate,white,66,C00,French Defense: Knight Variation
1701,1680,97,mate,white,21,C00,French Defense: Knight Variation
1661,1675,33,mate,white,14,C00,French Defense: Knight Variation
1383,1045,77,mate,white,338,C00,French Defense: Knight Variation
1383,1045,45,mate,white,338,C00,French Defense: Knight Variation
1364,1065,77,mate,white,299,C00,French Defense: Knight Variation
1336,1088,37,resign,white,248,C00,French Defense: Knight Variation
1208,1123,67,resign,white,85,C00,French Defense: Knight Variation
1668,1543,81,resign,white,125,C00,French Defense: Knight Variation
1258,1673,21,resign,white,415,C00,French Defense: Knight Variation
1140,1117,59,time,white,23,C00,French Defense: Knight Variation
1552,1314,15,mate,white,238,C00,French Defense: Knight Variation
1475,1465,23,resign,white,10,C00,French Defense: Knight Variation
2105,2047,51,mate,white,58,C00,French Defense: Knight Variation
1429,1404,11,resign,white,25,C00,French Defense: Knight Variation
1488,1437,115,time,white,51,C00,French Defense: Knight Variation
1511,1017,67,mate,white,494,C00,French Defense: Knight Variation
1264,1064,57,resign,white,200,C00,French Defense: Knight Variation
1785,1481,109,resign,white,304,C00,French Defense: Knight Variation
1901,1827,61,resign,white,74,C00,French Defense: Knight Variation
1791,1803,83,resign,white,12,C00,French Defense: Knight Variation
1732,1085,39,mate,white,647,C00,French Defense: Knight Variation
1651,1740,35,resign,white,89,C00,French Defense: Knight Variation
1169,1276,49,mate,white,107,C00,French Defense: Knight Variation
1385,1291,37,mate,white,94,C00,French Defense: Knight Variation
1366,1308,31,resign,white,58,C00,French Defense: Knight Variation
1858,1450,54,resign,white,408,C00,French Defense: Knight Variation
2110,2095,81,resign,white,15,C00,French Defense: Knight Variation
2062,2140,63,resign,white,78,C00,French Defense: Knight Variation
2105,2145,33,mate,white,40,C00,French Defense: Knight Variation
1756,1835,125,resign,white,79,C00,French Defense: Knight Variation
1850,1812,59,mate,white,38,C00,French Defense: Knight Variation
1482,1648,36,resign,white,166,C00,French Defense: Knight Variation
1678,1658,49,resign,white,20,C00,French Defense: Knight Variation
1631,1665,45,resign,white,34,C00,French Defense: Knight Variation
1610,1672,33,resign,white,62,C00,French Defense: Knight Variation
1107,1201,95,time,white,94,C00,French Defense: Knight Variation
1356,1208,69,resign,white,148,C00,French Defense: Knight Variation
1264,1249,35,mate,white,15,C00,French Defense: Knight Variation
1441,1316,61,mate,white,125,C00,French Defense: Knight Variation
1408,1255,28,resign,white,153,C00,French Defense: Knight Variation
1321,1167,32,resign,white,154,C00,French Defense: Knight Variation
1303,1294,57,resign,white,9,C00,French Defense: Knight Variation
1906,1702,41,mate,white,204,C00,French Defense: Knight Variation
1912,1713,101,resign,white,199,C00,French Defense: Knight Variation
1362,1312,50,resign,white,50,C00,French Defense: Knight Variation
1954,2249,34,resign,white,295,C00,French Defense: Knight Variation
1526,1536,119,resign,white,10,C00,French Defense: Knight Variation
1494,1137,39,resign,white,357,C00,French Defense: La Bourdonnais Variation
1792,1600,72,resign,white,192,C00,French Defense: La Bourdonnais Variation
1940,1738,55,resign,white,202,C00,French Defense: La Bourdonnais Variation
2026,1883,29,mate,white,143,C00,French Defense: La Bourdonnais Variation
2017,1890,55,resign,white,127,C00,French Defense: La Bourdonnais Variation
1942,1739,101,resign,white,203,C10,French Defense: Marshall Variation
1568,1593,77,mate,white,25,C10,French Defense: Marshall Variation
1790,2034,33,resign,white,244,C10,French Defense: Marshall Variation
1428,1110,27,resign,white,318,C10,French Defense: Marshall Variation
1684,1107,51,mate,white,577,C01,French Defense: Mediterranean Defense
1351,1287,40,resign,white,64,C01,French Defense: Mediterranean Defense
1690,1679,75,mate,white,11,C01,French Defense: Mediterranean Defense
1330,1208,39,mate,white,122,C01,French Defense: Mediterranean Defense
1142,1226,27,mate,white,84,C00,French Defense: Normal Variation
1690,1613,71,mate,white,77,C00,French Defense: Normal Variation
1535,1273,46,resign,white,262,C00,French Defense: Normal Variation
1881,1828,121,resign,white,53,C00,French Defense: Normal Variation
1868,1824,75,mate,white,44,C00,French Defense: Normal Variation
1278,1173,75,time,white,105,C00,French Defense: Normal Variation
1233,1013,49,resign,white,220,C00,French Defense: Normal Variation
1308,1339,29,mate,white,31,C00,French Defense: Normal Variation
1281,930,95,mate,white,351,C00,French Defense: Normal Variation
1636,1116,39,mate,white,520,C00,French Defense: Normal Variation
1532,1472,99,time,white,60,C00,French Defense: Normal Variation
1697,1486,35,resign,white,211,C00,French Defense: Normal Variation
1709,1117,55,resign,white,592,C00,French Defense: Normal Variation
1512,1254,30,resign,white,258,C00,French Defense: Normal Variation
1955,1454,29,resign,white,501,C00,French Defense: Normal Variation
1586,1654,43,resign,white,68,C00,French Defense: Normal Variation
1273,1290,53,time,white,17,C00,French Defense: Normal Variation
1287,1203,79,time,white,84,C00,French Defense: Normal Variation
1306,1214,65,time,white,92,C00,French Defense: Normal Variation
1281,1224,69,mate,white,57,C00,French Defense: Normal Variation
1297,1217,57,mate,white,80,C00,French Defense: Normal Variation
1806,1673,53,mate,white,133,C00,French Defense: Normal Variation
1508,1511,55,resign,white,3,C00,French Defense: Normal Variation
1753,1441,57,mate,white,312,C00,French Defense: Normal Variation
1623,1442,113,resign,white,181,C00,French Defense: Normal Variation
1224,1133,55,resign,white,91,C00,French Defense: Normal Variation
1482,1311,47,mate,white,171,C00,French Defense: Normal Variation
1333,1586,29,mate,white,253,C00,French Defense: Normal Variation
1916,1072,29,mate,white,844,C00,French Defense: Normal Variation
1635,1432,37,mate,white,203,C00,French Defense: Normal Variation
1852,1518,79,resign,white,334,C00,French Defense: Normal Variation
1773,1751,115,mate,white,22,C00,French Defense: Normal Variation
1411,1303,73,resign,white,108,C00,French Defense: Normal Variation
1325,921,19,resign,white,404,C10,French Defense: Paulsen Variation
2211,1900,69,mate,white,311,C10,French Defense: Paulsen Variation
1220,1205,77,time,white,15,C10,French Defense: Paulsen Variation
1570,1321,101,resign,white,249,C10,French Defense: Paulsen Variation
2070,1821,53,time,white,249,C10,French Defense: Paulsen Variation
1562,1503,53,resign,white,59,C10,French Defense: Paulsen Variation
1568,1636,35,resign,white,68,C00,French Defense: Pelikan Variation
1554,1532,65,resign,white,22,C01,French Defense: Perseus Gambit
1603,1550,69,resign,white,53,C00,French Defense: Queen's Knight
1584,1957,52,resign,white,373,C00,French Defense: Queen's Knight
1215,1511,39,mate,white,296,C00,French Defense: Queen's Knight
1610,1599,67,time,white,11,C00,French Defense: Queen's Knight
1315,1305,11,resign,white,10,C00,French Defense: Queen's Knight
1379,967,69,resign,white,412,C00,French Defense: Queen's Knight
967,1078,69,resign,white,111,C00,French Defense: Queen's Knight
1542,1284,27,mate,white,258,C00,French Defense: Queen's Knight
2304,2194,51,resign,white,110,C00,French Defense: Reti-Spielmann Attack
2181,2327,9,resign,white,146,C10,French Defense: Rubinstein Variation
1522,1434,57,mate,white,88,C10,French Defense: Rubinstein Variation
1557,1443,41,mate,white,114,C10,French Defense: Rubinstein Variation |  Blackburne Defense
1922,1693,75,resign,white,229,C10,French Defense: Rubinstein Variation |  Blackburne Defense
1695,1754,85,resign,white,59,C10,French Defense: Rubinstein Variation |  Blackburne Defense
1841,1737,49,resign,white,104,C10,French Defense: Rubinstein Variation |  Blackburne Defense
1743,1738,39,resign,white,5,C10,French Defense: Rubinstein Variation |  Fort Knox Variation
1967,1775,40,resign,white,192,C00,French Defense: Schlechter Variation
2096,1870,79,mate,white,226,C00,French Defense: Steiner Variation
1474,1312,43,resign,white,162,C00,French Defense: Steiner Variation
2049,1815,85,mate,white,234,C00,French Defense: Steiner Variation
1532,1500,59,mate,white,32,C00,French Defense: Steinitz Attack
1597,1583,53,resign,white,14,C00,French Defense: Steinitz Attack
1403,1364,113,mate,white,39,C00,French Defense: Steinitz Attack
1403,1364,113,mate,white,39,C00,French Defense: Steinitz Attack
1307,1272,43,mate,white,35,C00,French Defense: Steinitz Attack
1383,1386,89,time,white,3,C00,French Defense: Steinitz Attack
1535,1182,41,time,white,353,C00,French Defense: Steinitz Attack
1679,1517,59,mate,white,162,C00,French Defense: Steinitz Attack
1465,1119,31,mate,white,346,C00,French Defense: Steinitz Attack
1894,1865,35,resign,white,29,C00,French Defense: Steinitz Attack
1980,1627,123,resign,white,353,C00,French Defense: Steinitz Attack
1980,1860,89,mate,white,120,C11,French Defense: Steinitz Variation #2
1986,2009,47,resign,white,23,C11,French Defense: Steinitz Variation |  Boleslavsky Variation
2264,2016,63,resign,white,248,C11,French Defense: Steinitz Variation |  Boleslavsky Variation
2401,2128,23,resign,white,273,C11,French Defense: Steinitz Variation |  Boleslavsky Variation
1989,1945,52,resign,white,44,C03,French Defense: Tarrasch Variation
2019,1805,137,mate,white,214,C05,French Defense: Tarrasch Variation |  Closed Variation
1245,1259,33,mate,white,14,C00,French Defense: Two Knights Variation
1299,1378,50,resign,white,79,C00,French Defense: Two Knights Variation
1503,1664,23,time,white,161,C00,French Defense: Two Knights Variation
1276,1132,16,resign,white,144,C00,French Defense: Two Knights Variation
1321,1771,73,mate,white,450,C00,French Defense: Two Knights Variation
1551,1486,89,resign,white,65,C16,French Defense: Winawer Variation |  Advance Variation
2203,2061,101,mate,white,142,C17,French Defense: Winawer Variation |  Advance Variation
1963,1866,32,resign,white,97,C17,French Defense: Winawer Variation |  Advance Variation
2006,1757,91,mate,white,249,C18,French Defense: Winawer Variation |  Advance Variation
1602,1532,39,resign,white,70,C18,French Defense: Winawer Variation |  Advance Variation #2
1879,1790,87,resign,white,89,C17,French Defense: Winawer Variation |  Advance Variation #3
1955,1850,20,resign,white,105,C15,French Defense: Winawer Variation |  Alekhine-Maroczy Gambit
1776,1888,51,resign,white,112,C01,French Defense: Winawer Variation |  Delayed Exchange Variation
1672,1774,35,resign,white,102,C18,French Defense: Winawer Variation |  Maroczy-Wallis Variation
2409,2314,55,mate,white,95,C18,French Defense: Winawer Variation |  Maroczy-Wallis Variation
1979,1786,19,resign,white,193,C18,French Defense: Winawer Variation |  Maroczy-Wallis Variation
1928,1688,51,resign,white,240,C18,French Defense: Winawer Variation |  Retreat Variation
1099,1173,16,resign,white,74,C15,French Defense: Winawer Variation |  Winckelmann-Riemer Gambit
1469,1445,57,resign,white,24,A00,Gedult's Opening
1437,1645,129,resign,white,208,A00,Gedult's Opening
1625,1384,59,mate,white,241,C50,Giuoco Piano
1516,1345,77,mate,white,171,C50,Giuoco Piano
1264,1367,17,mate,white,103,C50,Giuoco Piano
1293,2123,89,mate,white,830,C50,Giuoco Piano
1632,1541,47,resign,white,91,C50,Giuoco Piano
1852,1761,27,mate,white,91,C50,Giuoco Piano
1734,1805,103,resign,white,71,C50,Giuoco Piano
1268,1316,89,resign,white,48,C50,Giuoco Piano
1661,1653,113,mate,white,8,C50,Giuoco Piano
1333,1302,67,resign,white,31,C50,Giuoco Piano
2328,2031,44,resign,white,297,C50,Giuoco Piano
1480,1462,38,resign,white,18,C50,Giuoco Piano
1790,1657,27,resign,white,133,C50,Giuoco Piano
1850,1285,71,resign,white,565,C50,Giuoco Piano
1462,1464,51,resign,white,2,A00,Global Opening
1248,1253,39,mate,white,5,B00,Goldsmith Defense
1210,1112,39,mate,white,98,B00,Goldsmith Defense
1899,1263,63,mate,white,636,B00,Goldsmith Defense
1282,1161,57,mate,white,121,A00,Grob Opening
1471,1397,51,mate,white,74,A00,Grob Opening: Spike |  Hurst Attack
2199,1677,23,mate,white,522,D85,Gruenfeld Defense: Exchange Variation
1920,1682,26,resign,white,238,D85,Gruenfeld Defense: Exchange Variation
1742,1856,89,resign,white,114,D85,Gruenfeld Defense: Exchange Variation |  Modern Exchange Variation
1943,2091,49,resign,white,148,D85,Gruenfeld Defense: Exchange Variation |  Modern Exchange Variation
1700,1715,99,resign,white,15,D85,Gruenfeld Defense: Exchange Variation |  Modern Exchange Variation
2029,2040,33,resign,white,11,D80,Gruenfeld Defense: Stockholm Variation
1841,1636,73,mate,white,205,D90,Gruenfeld Defense: Three Knights Variation #2
1761,1415,39,resign,white,346,D94,Gruenfeld Defense: Three Knights Variation |  Burille Variation
2003,1942,127,resign,white,61,D94,Gruenfeld Defense: Three Knights Variation |  Burille Variation
1786,1795,75,mate,white,9,D93,Gruenfeld Defense: Three Knights Variation |  Hungarian Variation
1447,1479,71,time,white,32,D94,Gruenfeld Defense: Three Knights Variation |  Paris Variation
1718,1345,51,mate,white,373,B00,Guatemala Defense
1790,1265,41,resign,white,525,C40,Gunderam Defense
1473,1311,27,resign,white,162,C40,Gunderam Defense
1189,1373,171,mate,white,184,C40,Gunderam Defense
1137,1190,56,resign,white,53,B00,Hippopotamus Defense #2
1589,1547,50,resign,white,42,A40,Horwitz Defense
1513,1784,85,mate,white,271,A40,Horwitz Defense
1559,1423,38,resign,white,136,A40,Horwitz Defense
1413,1434,15,resign,white,21,A40,Horwitz Defense
1325,1218,31,mate,white,107,A40,Horwitz Defense
1285,1321,41,resign,white,36,A40,Horwitz Defense
1889,1389,39,mate,white,500,A40,Horwitz Defense
1870,1202,75,mate,white,668,A40,Horwitz Defense
1878,1534,57,mate,white,344,A40,Horwitz Defense
1824,1500,43,mate,white,324,A40,Horwitz Defense
1430,1256,49,mate,white,174,A40,Horwitz Defense
1828,1767,87,resign,white,61,A40,Horwitz Defense
1688,1414,52,resign,white,274,A40,Horwitz Defense
1151,1202,55,mate,white,51,A40,Horwitz Defense
1554,1546,81,resign,white,8,A40,Horwitz Defense
2188,2173,35,resign,white,15,A40,Horwitz Defense
2221,2222,35,mate,white,1,A40,Horwitz Defense
2218,2133,67,time,white,85,A40,Horwitz Defense
1805,1176,10,resign,white,629,A40,Horwitz Defense
1347,1013,35,mate,white,334,A40,Horwitz Defense
1681,1874,59,resign,white,193,A40,Horwitz Defense
2062,1814,65,resign,white,248,A40,Horwitz Defense
1127,1108,77,time,white,19,A40,Horwitz Defense
2262,2104,137,mate,white,158,A40,Horwitz Defense
2343,2259,43,resign,white,84,A40,Horwitz Defense
1881,1857,31,resign,white,24,A40,Horwitz Defense
1862,1825,61,resign,white,37,A40,Horwitz Defense
1782,1884,37,mate,white,102,A40,Horwitz Defense
1659,1470,37,resign,white,189,A40,Horwitz Defense
1174,955,53,resign,white,219,A40,Horwitz Defense
1788,1473,151,mate,white,315,A40,Horwitz Defense
1689,1630,69,mate,white,59,A40,Horwitz Defense
1314,1196,75,mate,white,118,A40,Horwitz Defense
1386,1224,56,resign,white,162,A40,Horwitz Defense
1352,1272,33,resign,white,80,A40,Horwitz Defense
1450,1551,105,resign,white,101,A40,Horwitz Defense
1759,1608,115,mate,white,151,A40,Horwitz Defense
1365,1301,115,mate,white,64,A40,Horwitz Defense
1480,1508,59,time,white,28,A40,Horwitz Defense
1485,1490,63,resign,white,5,A40,Horwitz Defense
1449,1377,45,resign,white,72,A40,Horwitz Defense
1596,1535,47,mate,white,61,A40,Horwitz Defense
1629,1858,13,resign,white,229,A40,Horwitz Defense
1504,1241,115,resign,white,263,A40,Horwitz Defense
1526,1290,95,mate,white,236,A00,Hungarian Opening
1344,1018,69,mate,white,326,A00,Hungarian Opening
1981,1818,69,resign,white,163,A00,Hungarian Opening
1739,1260,12,resign,white,479,A00,Hungarian Opening
1160,1369,40,resign,white,209,A00,Hungarian Opening
1114,1189,85,resign,white,75,A00,Hungarian Opening
1115,1013,139,mate,white,102,A00,Hungarian Opening
1151,964,43,mate,white,187,A00,Hungarian Opening
1518,1419,83,resign,white,99,A00,Hungarian Opening
1739,1260,12,resign,white,479,A00,Hungarian Opening
1567,1108,59,time,white,459,A00,Hungarian Opening
1616,1404,163,mate,white,212,A00,Hungarian Opening
1613,1279,19,resign,white,334,A00,Hungarian Opening
1607,1403,53,resign,white,204,A00,Hungarian Opening
1600,1421,71,resign,white,179,A00,Hungarian Opening
1272,986,73,time,white,286,A00,Hungarian Opening
1142,1066,43,resign,white,76,A00,Hungarian Opening
1150,1223,47,mate,white,73,A00,Hungarian Opening
1709,1703,51,resign,white,6,A00,Hungarian Opening
1750,1775,53,resign,white,25,A00,Hungarian Opening
1460,1153,41,mate,white,307,A00,Hungarian Opening
1488,1015,37,mate,white,473,A00,Hungarian Opening
1620,1632,57,resign,white,12,A00,Hungarian Opening
1927,1840,42,resign,white,87,A00,Hungarian Opening
1245,1079,119,mate,white,166,A00,Hungarian Opening
1384,1821,103,time,white,437,A00,Hungarian Opening
1424,1280,31,mate,white,144,A00,Hungarian Opening
1504,1139,43,mate,white,365,A00,Hungarian Opening
1513,1156,73,mate,white,357,A00,Hungarian Opening
1507,1248,59,mate,white,259,A00,Hungarian Opening
1502,1227,53,mate,white,275,A00,Hungarian Opening
1498,1147,23,resign,white,351,A00,Hungarian Opening
1485,1298,49,resign,white,187,A00,Hungarian Opening
1513,1273,35,resign,white,240,A00,Hungarian Opening: Catalan Formation
1635,1358,47,mate,white,277,A00,Hungarian Opening: Indian Defense
1352,1496,31,resign,white,144,A00,Hungarian Opening: Reversed Alekhine
1455,1336,53,time,white,119,A00,Hungarian Opening: Sicilian Invitation
2249,2153,75,resign,white,96,A00,Hungarian Opening: Symmetrical Variation
1497,1113,105,time,white,384,A00,Hungarian Opening: Symmetrical Variation
1561,1596,57,resign,white,35,A45,Indian Game
1617,1590,87,mate,white,27,A45,Indian Game
1546,1571,60,resign,white,25,A45,Indian Game
2100,1960,115,mate,white,140,A45,Indian Game
1363,1287,123,mate,white,76,A45,Indian Game
1650,1756,89,mate,white,106,A45,Indian Game
1501,1484,43,resign,white,17,A45,Indian Game
1652,1674,65,resign,white,22,A45,Indian Game
1429,1416,61,resign,white,13,A45,Indian Game
1563,1352,25,time,white,211,A45,Indian Game
1822,1562,119,resign,white,260,A45,Indian Game
1478,1458,46,resign,white,20,A45,Indian Game
2175,2231,77,resign,white,56,A45,Indian Game
1839,1743,117,time,white,96,A45,Indian Game
1907,1906,47,resign,white,1,A45,Indian Game
1343,1470,43,resign,white,127,A45,Indian Game
1531,1475,99,resign,white,56,A45,Indian Game
1865,1953,65,resign,white,88,A45,Indian Game
1445,1426,63,mate,white,19,A45,Indian Game
1869,1724,165,time,white,145,A45,Indian Game
1766,1655,41,mate,white,111,A45,Indian Game
1513,1197,45,mate,white,316,E10,Indian Game: Anti-Nimzo-Indian
1758,1804,4,resign,white,46,A51,Indian Game: Budapest Defense
1623,1538,71,resign,white,85,A51,Indian Game: Budapest Defense
1923,1967,103,resign,white,44,A48,Indian Game: Colle System |  King's Indian Variation
1643,1558,42,resign,white,85,E00,Indian Game: East Indian Defense
1289,1455,117,resign,white,166,E00,Indian Game: East Indian Defense
1334,1428,47,resign,white,94,E00,Indian Game: East Indian Defense
2047,1268,135,resign,white,779,A46,Indian Game: London System
2050,1950,33,resign,white,100,A46,Indian Game: London System
1707,1586,59,time,white,121,A50,Indian Game: Normal Variation
1107,1022,57,mate,white,85,A45,Indian Game: Paleface Attack |  Blackmar-Diemer Gambit Deferred
2276,2230,83,mate,white,46,A46,Indian Game: Spielmann-Indian
2038,1934,141,resign,white,104,A46,Indian Game: Spielmann-Indian
1478,1513,43,resign,white,35,A45,Indian Game: Tartakower Attack
1215,921,23,mate,white,294,C50,Italian Game
1354,1217,31,mate,white,137,C50,Italian Game
1437,1552,57,resign,white,115,C50,Italian Game
1612,1614,19,resign,white,2,C50,Italian Game
1626,1631,45,resign,white,5,C50,Italian Game
1152,1271,25,mate,white,119,C50,Italian Game
1328,1295,15,mate,white,33,C50,Italian Game
1275,1308,43,mate,white,33,C50,Italian Game
1809,1314,31,resign,white,495,C50,Italian Game
1529,1610,15,mate,white,81,C50,Italian Game
1705,1135,61,time,white,570,C50,Italian Game
1759,1163,19,mate,white,596,C50,Italian Game
1804,1284,31,time,white,520,C50,Italian Game
1455,1177,9,resign,white,278,C50,Italian Game
1819,1128,64,resign,white,691,C50,Italian Game
1573,1179,51,mate,white,394,C50,Italian Game
1785,1132,17,resign,white,653,C50,Italian Game
1676,1661,55,resign,white,15,C50,Italian Game
1677,1425,18,resign,white,252,C50,Italian Game
1482,1508,47,resign,white,26,C50,Italian Game
1252,1360,13,mate,white,108,C50,Italian Game
1538,1531,33,resign,white,7,C50,Italian Game
1418,1419,117,mate,white,1,C50,Italian Game
1387,1546,24,resign,white,159,C50,Italian Game
1575,1545,40,resign,white,30,C50,Italian Game
1737,1674,77,mate,white,63,C50,Italian Game
1412,1321,77,mate,white,91,C50,Italian Game
1280,1485,159,mate,white,205,C55,Italian Game: Anti-Fried Liver Defense
1638,1614,97,mate,white,24,C55,Italian Game: Anti-Fried Liver Defense
1630,1638,71,resign,white,8,C55,Italian Game: Anti-Fried Liver Defense
1833,1740,23,resign,white,93,C55,Italian Game: Anti-Fried Liver Defense
1713,1659,91,mate,white,54,C55,Italian Game: Anti-Fried Liver Defense
1453,1724,51,resign,white,271,C55,Italian Game: Anti-Fried Liver Defense
1686,1681,55,resign,white,5,C55,Italian Game: Anti-Fried Liver Defense
1853,1675,67,resign,white,178,C55,Italian Game: Anti-Fried Liver Defense
1730,1703,87,mate,white,27,C55,Italian Game: Anti-Fried Liver Defense
1772,1713,61,resign,white,59,C55,Italian Game: Anti-Fried Liver Defense
1466,1046,19,resign,white,420,C55,Italian Game: Anti-Fried Liver Defense
1684,1703,23,resign,white,19,C55,Italian Game: Anti-Fried Liver Defense
1441,1462,43,mate,white,21,C55,Italian Game: Anti-Fried Liver Defense
1378,1071,27,resign,white,307,C55,Italian Game: Anti-Fried Liver Defense
1482,1648,45,resign,white,166,C55,Italian Game: Anti-Fried Liver Defense
1480,1637,23,resign,white,157,C55,Italian Game: Anti-Fried Liver Defense
1556,1676,81,time,white,120,C55,Italian Game: Anti-Fried Liver Defense
1661,1666,27,resign,white,5,C55,Italian Game: Anti-Fried Liver Defense
1972,1643,57,mate,white,329,C55,Italian Game: Anti-Fried Liver Defense
1679,1834,67,mate,white,155,C55,Italian Game: Anti-Fried Liver Defense
1782,1417,45,time,white,365,C55,Italian Game: Anti-Fried Liver Defense
1684,1394,51,mate,white,290,C55,Italian Game: Anti-Fried Liver Defense
1368,1512,21,resign,white,144,C55,Italian Game: Anti-Fried Liver Defense
1491,1377,29,resign,white,114,C55,Italian Game: Anti-Fried Liver Defense
1670,1352,65,mate,white,318,C55,Italian Game: Anti-Fried Liver Defense
2247,1718,45,resign,white,529,C55,Italian Game: Anti-Fried Liver Defense
1742,1321,17,mate,white,421,C55,Italian Game: Anti-Fried Liver Defense
1278,1801,17,resign,white,523,C55,Italian Game: Anti-Fried Liver Defense
1500,1346,15,mate,white,154,C55,Italian Game: Anti-Fried Liver Defense
1517,1772,55,resign,white,255,C55,Italian Game: Anti-Fried Liver Defense
1939,2011,81,time,white,72,C55,Italian Game: Anti-Fried Liver Defense
1730,1603,23,resign,white,127,C55,Italian Game: Anti-Fried Liver Defense
1545,1714,119,mate,white,169,C53,Italian Game: Bird's Attack
1637,1627,29,resign,white,10,C53,Italian Game: Classical Variation #2
1353,1170,73,time,white,183,C53,Italian Game: Classical Variation #2
1462,1441,43,resign,white,21,C53,Italian Game: Classical Variation #2
1749,1716,51,resign,white,33,C53,Italian Game: Classical Variation #2
1578,1576,63,resign,white,2,C53,Italian Game: Classical Variation #2
1498,1780,51,time,white,282,C53,Italian Game: Classical Variation #2
2044,2047,15,resign,white,3,C53,Italian Game: Classical Variation #2
1938,1500,89,mate,white,438,C53,Italian Game: Classical Variation #2
1171,1190,59,resign,white,19,C53,Italian Game: Classical Variation |  Center Attack
1245,1170,73,resign,white,75,C53,Italian Game: Classical Variation |  Giuoco Pianissimo
1426,1411,19,mate,white,15,C53,Italian Game: Classical Variation |  Giuoco Pianissimo
1553,1459,40,resign,white,94,C53,Italian Game: Classical Variation |  Giuoco Pianissimo
1500,1772,41,mate,white,272,C53,Italian Game: Classical Variation |  Giuoco Pianissimo
1581,1690,97,mate,white,109,C54,Italian Game: Classical Variation |  Greco Gambit |  Traditional Line
1842,1300,23,resign,white,542,C55,Italian Game: Deutz Gambit
1769,1926,49,resign,white,157,C55,Italian Game: Deutz Gambit
1444,1242,31,mate,white,202,C51,Italian Game: Evans Gambit
1603,1609,71,mate,white,6,C51,Italian Game: Evans Gambit Declined
1566,1196,89,mate,white,370,C51,Italian Game: Evans Gambit |  McDonnell Defense
1841,1900,67,mate,white,59,C52,Italian Game: Evans Gambit |  Pierce Defense
1443,1454,65,mate,white,11,C50,Italian Game: Giuoco Pianissimo
1679,1694,123,time,white,15,C50,Italian Game: Giuoco Pianissimo
1402,1481,103,resign,white,79,C50,Italian Game: Giuoco Pianissimo
1671,1575,33,resign,white,96,C50,Italian Game: Giuoco Pianissimo
1603,1402,21,resign,white,201,C50,Italian Game: Giuoco Pianissimo |  Italian Four Knights Variation
1491,1525,61,resign,white,34,C50,Italian Game: Giuoco Pianissimo |  Italian Four Knights Variation
1700,1714,45,resign,white,14,C50,Italian Game: Giuoco Pianissimo |  Italian Four Knights Variation
1673,1510,115,resign,white,163,C50,Italian Game: Giuoco Pianissimo |  Italian Four Knights Variation
1579,1731,115,resign,white,152,C50,Italian Game: Giuoco Pianissimo |  Italian Four Knights Variation
1745,1556,99,resign,white,189,C50,Italian Game: Giuoco Pianissimo |  Italian Four Knights Variation
1345,1235,43,resign,white,110,C50,Italian Game: Giuoco Pianissimo |  Italian Four Knights Variation
1500,1442,57,mate,white,58,C50,Italian Game: Giuoco Pianissimo |  Italian Four Knights Variation
1605,1624,22,resign,white,19,C50,Italian Game: Giuoco Pianissimo |  Normal
1332,1287,27,mate,white,45,C50,Italian Game: Giuoco Pianissimo |  Normal
1403,1403,45,mate,white,0,C50,Italian Game: Giuoco Pianissimo |  Normal
1344,1390,15,mate,white,46,C50,Italian Game: Giuoco Pianissimo |  Normal
1633,1595,23,resign,white,38,C50,Italian Game: Giuoco Pianissimo |  Normal
1668,1976,71,resign,white,308,C50,Italian Game: Giuoco Pianissimo |  Normal
1758,1649,39,mate,white,109,C50,Italian Game: Giuoco Pianissimo |  Normal
1623,1456,13,resign,white,167,C50,Italian Game: Giuoco Pianissimo |  Normal
1579,1623,123,mate,white,44,C54,Italian Game: Giuoco Piano |  Aitken Variation
2000,1962,45,resign,white,38,C54,Italian Game: Giuoco Piano |  Greco's Attack
1567,1238,57,resign,white,329,C50,Italian Game: Hungarian Defense
1562,1534,49,mate,white,28,C50,Italian Game: Rousseau Gambit
1720,1538,25,mate,white,182,C50,Italian Game: Rousseau Gambit
1581,1541,43,resign,white,40,C50,Italian Game: Schilling-Kostic Gambit
1724,1560,79,resign,white,164,C50,Italian Game: Schilling-Kostic Gambit
1670,1588,53,resign,white,82,C50,Italian Game: Schilling-Kostic Gambit
2105,1681,65,resign,white,424,C55,Italian Game: Scotch Gambit |  de Riviere Defense
1235,1669,25,mate,white,434,C55,Italian Game: Two Knights Defense
1795,1635,25,mate,white,160,C55,Italian Game: Two Knights Defense
1223,1189,95,mate,white,34,C57,Italian Game: Two Knights Defense |  Fried Liver Attack
1279,1267,17,mate,white,12,C57,Italian Game: Two Knights Defense |  Fried Liver Attack
1432,1456,25,mate,white,24,C57,Italian Game: Two Knights Defense |  Fried Liver Attack
1231,1295,17,mate,white,64,C57,Italian Game: Two Knights Defense |  Fried Liver Attack
1466,1358,79,resign,white,108,C57,Italian Game: Two Knights Defense |  Fried Liver Attack
1495,1440,17,resign,white,55,C57,Italian Game: Two Knights Defense |  Fried Liver Attack
1739,1395,39,resign,white,344,C57,Italian Game: Two Knights Defense |  Fried Liver Attack
1682,1396,17,mate,white,286,C57,Italian Game: Two Knights Defense |  Fried Liver Attack
1619,1419,47,mate,white,200,C57,Italian Game: Two Knights Defense |  Knight Attack
1867,1399,13,resign,white,468,C57,Italian Game: Two Knights Defense |  Knight Attack
1468,1381,41,resign,white,87,C57,Italian Game: Two Knights Defense |  Knight Attack
1430,1187,9,resign,white,243,C57,Italian Game: Two Knights Defense |  Knight Attack
1427,970,53,resign,white,457,C57,Italian Game: Two Knights Defense |  Knight Attack
1547,1564,57,mate,white,17,C57,Italian Game: Two Knights Defense |  Knight Attack |  Normal Variation
1442,1270,17,mate,white,172,C57,Italian Game: Two Knights Defense |  Knight Attack |  Normal Variation
1364,1327,91,resign,white,37,C57,Italian Game: Two Knights Defense |  Knight Attack |  Normal Variation
1783,1364,49,resign,white,419,C57,Italian Game: Two Knights Defense |  Knight Attack |  Normal Variation
1500,963,31,resign,white,537,C57,Italian Game: Two Knights Defense |  Knight Attack |  Normal Variation
1509,1482,61,resign,white,27,C57,Italian Game: Two Knights Defense |  Knight Attack |  Normal Variation
1359,1342,53,resign,white,17,C57,Italian Game: Two Knights Defense |  Knight Attack |  Normal Variation
1157,1234,51,resign,white,77,C55,Italian Game: Two Knights Defense |  Modern Bishop's Opening
1444,1651,99,resign,white,207,C55,Italian Game: Two Knights Defense |  Modern Bishop's Opening
1507,1497,67,resign,white,10,C55,Italian Game: Two Knights Defense |  Modern Bishop's Opening
1639,1807,19,resign,white,168,C55,Italian Game: Two Knights Defense |  Modern Bishop's Opening
1774,1894,63,resign,white,120,C55,Italian Game: Two Knights Defense |  Modern Bishop's Opening
1738,1370,31,resign,white,368,C55,Italian Game: Two Knights Defense |  Modern Bishop's Opening
2010,1419,81,mate,white,591,C55,Italian Game: Two Knights Defense |  Modern Bishop's Opening
1441,1366,39,resign,white,75,C55,Italian Game: Two Knights Defense |  Modern Bishop's Opening
2145,2193,135,mate,white,48,C55,Italian Game: Two Knights Defense |  Modern Bishop's Opening
1525,1343,99,resign,white,182,C55,Italian Game: Two Knights Defense |  Modern Bishop's Opening
1697,1705,87,mate,white,8,C55,Italian Game: Two Knights Defense |  Modern Bishop's Opening
1949,1845,111,resign,white,104,C55,Italian Game: Two Knights Defense |  Modern Bishop's Opening
1832,1626,101,mate,white,206,C55,Italian Game: Two Knights Defense |  Modern Bishop's Opening
1282,1451,91,mate,white,169,C55,Italian Game: Two Knights Defense |  Modern Bishop's Opening
2199,1802,25,resign,white,397,C55,Italian Game: Two Knights Defense |  Modern Bishop's Opening
2021,1711,82,resign,white,310,C55,Italian Game: Two Knights Defense |  Modern Bishop's Opening
1808,1619,34,resign,white,189,C55,Italian Game: Two Knights Defense |  Modern Bishop's Opening
1603,1384,59,mate,white,219,C55,Italian Game: Two Knights Defense |  Open Variation
1621,1673,59,resign,white,52,C57,Italian Game: Two Knights Defense |  Polerio Defense
1392,1284,23,mate,white,108,C57,Italian Game: Two Knights Defense |  Polerio Defense
1535,1609,177,time,white,74,C58,Italian Game: Two Knights Defense |  Polerio Defense |  Bishop Check Line
1966,1679,68,resign,white,287,C58,Italian Game: Two Knights Defense |  Polerio Defense |  Bishop Check Line
1835,1760,21,mate,white,75,C58,Italian Game: Two Knights Defense |  Polerio Defense |  Kieseritzky Variation
1826,1900,73,resign,white,74,C59,Italian Game: Two Knights Defense |  Polerio Defense |  Suhle Defense
1659,2126,91,resign,white,467,C59,Italian Game: Two Knights Defense |  Polerio Defense |  Suhle Defense
1237,1565,19,resign,white,328,C57,Italian Game: Two Knights Defense |  Traxler Counterattack |  Knight Sacrifice Line
1235,1376,55,mate,white,141,C57,Italian Game: Two Knights Defense |  Traxler Counterattack |  Knight Sacrifice Line
1496,1316,17,mate,white,180,C55,Italian Game: Two Knights Defense |  de Riviere Gambit
1338,1344,19,resign,white,6,A00,Kadas Opening
1498,1759,49,mate,white,261,A00,Kadas Opening
2259,1775,29,mate,white,484,A00,Kadas Opening
1563,1173,103,mate,white,390,E00,Kangaroo Defense
1167,1078,141,mate,white,89,E00,Kangaroo Defense: Keres Defense |  Transpositional Variation
1277,1122,57,mate,white,155,C30,King's Gambit
1671,1671,31,resign,white,0,C30,King's Gambit
1821,1641,5,resign,white,180,C30,King's Gambit
1774,1313,39,resign,white,461,C30,King's Gambit
1494,1348,71,mate,white,146,C30,King's Gambit
1359,1401,3,resign,white,42,C30,King's Gambit
1681,1150,79,resign,white,531,C30,King's Gambit
1439,1418,83,resign,white,21,C33,King's Gambit Accepted |  Bishop's Gambit
1810,1967,53,resign,white,157,C33,King's Gambit Accepted |  Bishop's Gambit
1870,1650,41,mate,white,220,C33,King's Gambit Accepted |  Bishop's Gambit |  Bogoljubov Variation
1450,1486,79,mate,white,36,C33,King's Gambit Accepted |  Bishop's Gambit |  Lopez Defense
1924,1674,67,resign,white,250,C35,King's Gambit Accepted |  Cunningham Defense
1560,1557,115,resign,white,3,C34,King's Gambit Accepted |  Fischer Defense
1365,1376,43,time,white,11,C34,King's Gambit Accepted |  Fischer Defense
1817,1396,29,mate,white,421,C34,King's Gambit Accepted |  King's Knight Gambit
1779,1727,41,resign,white,52,C34,King's Gambit Accepted |  King's Knight Gambit
1227,1204,9,resign,white,23,C34,King's Gambit Accepted |  King's Knight Gambit
1526,1529,41,resign,white,3,C34,King's Gambit Accepted |  King's Knight Gambit
1434,1422,41,resign,white,12,C34,King's Gambit Accepted |  King's Knight Gambit
2022,1877,61,resign,white,145,C34,King's Gambit Accepted |  King's Knight Gambit
1819,1345,37,resign,white,474,C34,King's Gambit Accepted |  MacLeod Defense
1829,1361,13,resign,white,468,C34,King's Gambit Accepted |  MacLeod Defense
1799,1782,47,resign,white,17,C34,King's Gambit Accepted |  MacLeod Defense
1877,1675,37,mate,white,202,C34,King's Gambit Accepted |  MacLeod Defense
1429,1460,41,resign,white,31,C34,King's Gambit Accepted |  MacLeod Defense
1718,1340,23,resign,white,378,C34,King's Gambit Accepted |  MacLeod Defense
2204,1967,39,mate,white,237,C34,King's Gambit Accepted |  MacLeod Defense
1662,1528,35,resign,white,134,C34,King's Gambit Accepted |  MacLeod Defense
1748,1730,43,resign,white,18,C36,King's Gambit Accepted |  Modern Defense
1420,1471,121,time,white,51,C33,King's Gambit Accepted |  Polerio Gambit
1743,1604,43,resign,white,139,C34,King's Gambit Accepted |  Schallopp Defense
1937,1507,33,resign,white,430,C34,King's Gambit Accepted |  Schallopp Defense
1514,1523,57,mate,white,9,C34,King's Gambit Accepted |  Schallopp Defense
1316,1282,61,mate,white,34,C34,King's Gambit Accepted |  Schallopp Defense
1679,1565,39,time,white,114,C34,King's Gambit Accepted |  Schallopp Defense
1896,1843,109,time,white,53,C34,King's Gambit Accepted |  Schallopp Defense
1903,1390,49,time,white,513,C34,King's Gambit Accepted |  Schallopp Defense
1538,1545,35,resign,white,7,C30,King's Gambit Declined |  Norwalde Variation
1586,1236,137,mate,white,350,C30,King's Gambit Declined |  Petrov's Defense
1678,1618,59,resign,white,60,C30,King's Gambit Declined |  Petrov's Defense
1259,1324,55,mate,white,65,C30,King's Gambit Declined |  Petrov's Defense
1976,1569,56,resign,white,407,C30,King's Gambit Declined |  Queen's Knight Defense
1857,1632,49,resign,white,225,C30,King's Gambit Declined |  Queen's Knight Defense
1565,1397,63,resign,white,168,C30,King's Gambit Declined |  Queen's Knight Defense
1023,1197,70,resign,white,174,C30,King's Gambit Declined: Keene's Defense #2
1559,1500,33,mate,white,59,C30,King's Gambit Declined: Keene's Defense #2
1290,1290,55,mate,white,0,C30,King's Gambit Declined: Keene's Defense #2
1309,1314,11,resign,white,5,C30,King's Gambit Declined: Keene's Defense #2
1645,1437,27,resign,white,208,C30,King's Gambit Declined: Keene's Defense #2
1724,1733,53,resign,white,9,A08,King's Indian Attack
1394,1659,52,resign,white,265,A08,King's Indian Attack
2218,2198,55,resign,white,20,A07,King's Indian Attack
1980,2071,35,resign,white,91,A08,King's Indian Attack
1937,1792,57,resign,white,145,A07,King's Indian Attack
1950,1901,29,resign,white,49,A08,King's Indian Attack
1185,1590,41,resign,white,405,A07,King's Indian Attack
2099,1829,71,mate,white,270,A08,King's Indian Attack
1391,1601,77,mate,white,210,A07,King's Indian Attack
1442,1221,61,mate,white,221,A07,King's Indian Attack
2214,2112,128,resign,white,102,A08,King's Indian Attack
1676,1669,83,resign,white,7,A07,King's Indian Attack
1874,1381,30,resign,white,493,A08,King's Indian Attack
1336,1287,105,resign,white,49,A07,King's Indian Attack: Keres Variation #2
1762,1833,59,resign,white,71,A07,King's Indian Attack: Sicilian Variation
1995,1581,129,mate,white,414,A05,King's Indian Attack: Symmetrical Defense
1783,1847,49,time,white,64,A05,King's Indian Attack: Symmetrical Defense
1678,1839,67,resign,white,161,A05,King's Indian Attack: Symmetrical Defense
1721,1736,35,mate,white,15,E61,King's Indian Defense
2150,1915,57,resign,white,235,E61,King's Indian Defense
2409,2182,65,resign,white,227,E61,King's Indian Defense
1397,1394,105,time,white,3,E61,King's Indian Defense
1420,1403,33,mate,white,17,E61,King's Indian Defense
1593,1442,60,resign,white,151,E61,King's Indian Defense
1648,1695,64,resign,white,47,E61,King's Indian Defense
2136,2039,81,resign,white,97,E61,King's Indian Defense
1721,1661,41,resign,white,60,E61,King's Indian Defense
1445,1407,115,mate,white,38,E61,King's Indian Defense: 3.Nc3
1858,1674,55,resign,white,184,E61,King's Indian Defense: 3.Nc3
1899,1950,103,time,white,51,E70,King's Indian Defense: Accelerated Averbakh Variation
1954,1912,37,mate,white,42,E73,King's Indian Defense: Averbakh Variation |  Flexible Defense
2338,2272,95,time,white,66,E73,King's Indian Defense: Averbakh Variation |  Flexible Defense
2052,1971,51,mate,white,81,E76,King's Indian Defense: Four Pawns Attack |  Dynamic Attack
1689,1637,45,resign,white,52,E90,King's Indian Defense: Larsen Variation
1604,1446,69,resign,white,158,E71,King's Indian Defense: Makogonov Variation
1993,1996,75,resign,white,3,E71,King's Indian Defense: Makogonov Variation
1689,1627,33,resign,white,62,E71,King's Indian Defense: Makogonov Variation
1391,1161,79,resign,white,230,E70,King's Indian Defense: Normal Variation
1522,1627,39,resign,white,105,E70,King's Indian Defense: Normal Variation
1946,1607,50,resign,white,339,E70,King's Indian Defense: Normal Variation
1649,1888,43,resign,white,239,E60,King's Indian Defense: Normal Variation |  King's Knight Variation
1932,1831,115,time,white,101,E60,King's Indian Defense: Normal Variation |  King's Knight Variation
1633,1591,43,resign,white,42,E60,King's Indian Defense: Normal Variation |  King's Knight Variation
1954,1578,133,mate,white,376,E90,King's Indian Defense: Normal Variation |  Rare Defenses
1517,1559,37,time,white,42,E90,King's Indian Defense: Normal Variation |  Rare Defenses
1871,1704,61,resign,white,167,E90,King's Indian Defense: Normal Variation |  Rare Defenses
1818,1368,53,mate,white,450,E90,King's Indian Defense: Normal Variation |  Rare Defenses
1821,1699,29,resign,white,122,E90,King's Indian Defense: Normal Variation |  Rare Defenses
1887,1905,41,resign,white,18,E90,King's Indian Defense: Normal Variation |  Rare Defenses
1825,2109,55,mate,white,284,E91,King's Indian Defense: Orthodox Variation
2084,1721,39,resign,white,363,E91,King's Indian Defense: Orthodox Variation
2311,1917,57,resign,white,394,E91,King's Indian Defense: Orthodox Variation
1907,1946,51,resign,white,39,E77,King's Indian Defense: Six Pawns Attack
1880,1803,111,resign,white,77,E77,King's Indian Defense: Six Pawns Attack
1762,1789,65,mate,white,27,E61,King's Indian Defense: Smyslov Variation
1337,1337,41,resign,white,0,C40,King's Knight Opening
1500,1534,69,resign,white,34,C40,King's Knight Opening
784,970,61,mate,white,186,C40,King's Knight Opening
1333,1471,49,mate,white,138,C40,King's Knight Opening
1170,981,43,time,white,189,C40,King's Knight Opening
1633,1104,13,mate,white,529,C40,King's Knight Opening
1483,1275,35,mate,white,208,C40,King's Knight Opening
1538,991,3,resign,white,547,C40,King's Knight Opening
1430,2173,3,resign,white,743,C40,King's Knight Opening
1848,1873,3,resign,white,25,C40,King's Knight Opening
1218,1158,67,time,white,60,C40,King's Knight Opening
1195,1159,119,mate,white,36,C40,King's Knight Opening
1472,1593,75,time,white,121,C40,King's Knight Opening
1456,1366,27,resign,white,90,C40,King's Knight Opening
1591,1778,41,resign,white,187,C40,King's Knight Opening
1423,1182,131,mate,white,241,C40,King's Knight Opening
1514,1350,113,mate,white,164,C40,King's Knight Opening
1747,1424,107,mate,white,323,C40,King's Knight Opening
1310,1303,77,mate,white,7,C40,King's Knight Opening
1255,1233,61,resign,white,22,C40,King's Knight Opening
1031,1063,55,mate,white,32,C40,King's Knight Opening
815,982,3,resign,white,167,C40,King's Knight Opening
1912,1339,53,mate,white,573,C40,King's Knight Opening
2269,1672,3,resign,white,597,C40,King's Knight Opening
1533,1270,31,resign,white,263,C40,King's Knight Opening
1576,1539,35,resign,white,37,C44,King's Knight Opening: Konstantinopolsky
1489,1545,123,mate,white,56,C44,King's Knight Opening: Konstantinopolsky
1976,1987,141,resign,white,11,C44,King's Knight Opening: Normal Variation
1804,1372,4,resign,white,432,C44,King's Knight Opening: Normal Variation
1295,1821,25,mate,white,526,C44,King's Knight Opening: Normal Variation
1275,1287,45,resign,white,12,C44,King's Knight Opening: Normal Variation
1611,1371,79,time,white,240,C44,King's Knight Opening: Normal Variation
1324,1795,95,mate,white,471,C44,King's Knight Opening: Normal Variation
1460,1242,67,mate,white,218,C44,King's Knight Opening: Normal Variation
1448,1461,21,resign,white,13,C44,King's Knight Opening: Normal Variation
1434,1665,45,resign,white,231,C44,King's Knight Opening: Normal Variation
1372,1409,65,mate,white,37,C44,King's Knight Opening: Normal Variation
1675,1486,47,mate,white,189,C44,King's Knight Opening: Normal Variation
1325,1227,4,resign,white,98,C44,King's Knight Opening: Normal Variation
1365,1345,45,mate,white,20,C44,King's Knight Opening: Normal Variation
1652,1566,69,resign,white,86,C44,King's Knight Opening: Normal Variation
1480,1389,73,resign,white,91,C44,King's Knight Opening: Normal Variation
1445,1649,65,resign,white,204,C44,King's Knight Opening: Normal Variation
1335,1318,84,resign,white,17,C44,King's Knight Opening: Normal Variation
1360,1440,69,resign,white,80,C44,King's Knight Opening: Normal Variation
1276,1333,45,resign,white,57,C44,King's Knight Opening: Normal Variation
1670,1175,1,resign,white,495,B00,King's Pawn
1778,1349,1,resign,white,429,B00,King's Pawn
1226,1112,39,mate,white,114,B00,King's Pawn
1484,2113,1,resign,white,629,B00,King's Pawn
1500,1414,44,resign,white,86,C20,King's Pawn Game
1511,1500,43,resign,white,11,C20,King's Pawn Game
1699,1508,69,mate,white,191,C20,King's Pawn Game
1758,1458,71,mate,white,300,C20,King's Pawn Game
1693,1586,41,mate,white,107,C20,King's Pawn Game
1487,1200,51,mate,white,287,C20,King's Pawn Game: Bavarian Gambit
1202,1238,31,mate,white,36,C21,King's Pawn Game: Beyer Gambit
1424,1092,27,resign,white,332,C21,King's Pawn Game: Beyer Gambit
1627,1649,33,resign,white,22,C21,King's Pawn Game: Beyer Gambit
1496,1546,41,mate,white,50,C21,King's Pawn Game: Beyer Gambit
1655,1470,89,resign,white,185,C21,King's Pawn Game: Beyer Gambit
1500,1688,85,resign,white,188,C40,King's Pawn Game: Busch-Gass Gambit
1871,1841,77,resign,white,30,C40,King's Pawn Game: Busch-Gass Gambit
1293,1342,157,mate,white,49,C40,King's Pawn Game: Busch-Gass Gambit
1344,1696,60,resign,white,352,C40,King's Pawn Game: Busch-Gass Gambit
1290,1548,37,mate,white,258,C40,King's Pawn Game: Busch-Gass Gambit
1258,1299,49,mate,white,41,C40,King's Pawn Game: Busch-Gass Gambit
1172,1122,69,mate,white,50,C40,King's Pawn Game: Busch-Gass Gambit
1834,1218,43,mate,white,616,C40,King's Pawn Game: Busch-Gass Gambit
2148,1947,65,time,white,201,C40,King's Pawn Game: Busch-Gass Gambit
1422,1040,43,mate,white,382,C40,King's Pawn Game: Busch-Gass Gambit
1011,1015,93,mate,white,4,C40,King's Pawn Game: Busch-Gass Gambit
1756,1569,21,mate,white,187,C40,King's Pawn Game: Busch-Gass Gambit
1525,1343,91,mate,white,182,C40,King's Pawn Game: Busch-Gass Gambit
1211,1366,41,mate,white,155,C40,King's Pawn Game: Busch-Gass Gambit
1654,1397,14,resign,white,257,C40,King's Pawn Game: Busch-Gass Gambit
1287,1205,111,mate,white,82,C40,King's Pawn Game: Busch-Gass Gambit
1470,1475,21,mate,white,5,C40,King's Pawn Game: Damiano Defense
1575,1281,63,time,white,294,C40,King's Pawn Game: Damiano Defense
1318,1169,17,resign,white,149,C40,King's Pawn Game: Damiano Defense
1132,1227,37,mate,white,95,C40,King's Pawn Game: Damiano Defense
1150,1004,61,time,white,146,C40,King's Pawn Game: Damiano Defense
1836,1500,27,mate,white,336,C40,King's Pawn Game: Damiano Defense
1342,1145,49,time,white,197,C40,King's Pawn Game: Damiano Defense
1450,1442,77,resign,white,8,C40,King's Pawn Game: Damiano Defense
1367,1346,31,resign,white,21,C40,King's Pawn Game: Damiano Defense
1419,1074,55,mate,white,345,C40,King's Pawn Game: Damiano Defense
1378,1170,13,resign,white,208,C40,King's Pawn Game: Damiano Defense
1549,1570,31,mate,white,21,C44,King's Pawn Game: Dresden Opening
1202,1522,115,resign,white,320,C44,King's Pawn Game: Dresden Opening
2053,1914,63,resign,white,139,C40,King's Pawn Game: Gunderam Gambit
2021,1921,67,resign,white,100,C40,King's Pawn Game: Gunderam Gambit
1179,1050,21,mate,white,129,C40,King's Pawn Game: Gunderam Gambit
1338,1264,31,mate,white,74,C20,King's Pawn Game: King's Head Opening
1276,1234,123,mate,white,42,C20,King's Pawn Game: King's Head Opening #2
1485,1519,99,mate,white,34,C20,King's Pawn Game: King's Head Opening #2
1618,1640,97,resign,white,22,C20,King's Pawn Game: King's Head Opening #2
1496,1500,61,mate,white,4,C20,King's Pawn Game: Leonardis Variation
1247,1122,53,mate,white,125,C20,King's Pawn Game: Leonardis Variation
813,841,32,resign,white,28,C20,King's Pawn Game: Leonardis Variation
1349,1276,49,mate,white,73,C20,King's Pawn Game: Leonardis Variation
958,1008,21,resign,white,50,C20,King's Pawn Game: Leonardis Variation
1326,1321,47,time,white,5,C20,King's Pawn Game: Leonardis Variation
1353,1568,11,resign,white,215,C20,King's Pawn Game: Leonardis Variation
1103,1146,67,mate,white,43,C20,King's Pawn Game: Leonardis Variation
1685,1499,123,mate,white,186,C20,King's Pawn Game: Leonardis Variation
1386,1352,91,resign,white,34,C20,King's Pawn Game: Leonardis Variation
1171,1408,63,mate,white,237,C20,King's Pawn Game: Leonardis Variation
1329,1166,11,time,white,163,C20,King's Pawn Game: Leonardis Variation
1309,1420,46,resign,white,111,C20,King's Pawn Game: Leonardis Variation
1384,1420,109,resign,white,36,C20,King's Pawn Game: Leonardis Variation
1581,1298,27,resign,white,283,C20,King's Pawn Game: Leonardis Variation
1185,1002,45,mate,white,183,C20,King's Pawn Game: Leonardis Variation
1831,1810,33,mate,white,21,C20,King's Pawn Game: Leonardis Variation
1263,1251,101,mate,white,12,C20,King's Pawn Game: Leonardis Variation
1500,1500,59,mate,white,0,C20,King's Pawn Game: Leonardis Variation
1296,1315,123,mate,white,19,C20,King's Pawn Game: Leonardis Variation
1460,1277,57,mate,white,183,C20,King's Pawn Game: Leonardis Variation
1688,1745,83,time,white,57,C20,King's Pawn Game: Leonardis Variation
1428,1411,35,mate,white,17,C20,King's Pawn Game: Leonardis Variation
1270,1408,59,time,white,138,C20,King's Pawn Game: Leonardis Variation
1392,1500,115,mate,white,108,C20,King's Pawn Game: Leonardis Variation
1830,1830,37,resign,white,0,C20,King's Pawn Game: Leonardis Variation
1278,1173,77,resign,white,105,C20,King's Pawn Game: Macleod Attack
1302,1236,19,resign,white,66,C20,King's Pawn Game: Macleod Attack
1340,1293,33,mate,white,47,C20,King's Pawn Game: Macleod Attack
1488,1451,111,resign,white,37,C20,King's Pawn Game: Macleod Attack
1319,1414,27,resign,white,95,C20,King's Pawn Game: Macleod Attack
1181,1200,55,time,white,19,B07,King's Pawn Game: Maroczy Defense
1504,1811,27,resign,white,307,B07,King's Pawn Game: Maroczy Defense
1140,1346,44,resign,white,206,B07,King's Pawn Game: Maroczy Defense
1452,1579,77,mate,white,127,B07,King's Pawn Game: Maroczy Defense
1649,1330,89,mate,white,319,B07,King's Pawn Game: Maroczy Defense
1550,1532,16,resign,white,18,B07,King's Pawn Game: Maroczy Defense
1320,1291,65,mate,white,29,C40,King's Pawn Game: McConnell Defense
1313,1349,60,resign,white,36,C40,King's Pawn Game: McConnell Defense
1430,1434,59,mate,white,4,C40,King's Pawn Game: McConnell Defense
1406,1371,65,resign,white,35,C40,King's Pawn Game: McConnell Defense
1002,1163,67,mate,white,161,C40,King's Pawn Game: McConnell Defense
1661,1132,67,mate,white,529,C40,King's Pawn Game: McConnell Defense
1217,1149,41,resign,white,68,C40,King's Pawn Game: McConnell Defense
1766,1709,17,resign,white,57,C40,King's Pawn Game: McConnell Defense
1710,1790,35,mate,white,80,C40,King's Pawn Game: McConnell Defense
1461,1398,49,resign,white,63,C40,King's Pawn Game: McConnell Defense
1376,1248,13,time,white,128,C40,King's Pawn Game: McConnell Defense
1972,1483,67,resign,white,489,C40,King's Pawn Game: McConnell Defense
1624,1402,61,mate,white,222,C40,King's Pawn Game: McConnell Defense
1597,1407,63,time,white,190,C40,King's Pawn Game: McConnell Defense
1485,1420,47,mate,white,65,C40,King's Pawn Game: McConnell Defense
1500,1465,29,mate,white,35,C40,King's Pawn Game: McConnell Defense
1515,1441,53,resign,white,74,C40,King's Pawn Game: McConnell Defense
1467,1267,71,resign,white,200,C20,King's Pawn Game: Mengarini's Opening
1418,1415,29,mate,white,3,C20,King's Pawn Game: Napoleon Attack
1307,1180,45,resign,white,127,C20,King's Pawn Game: Napoleon Attack
1371,1315,45,mate,white,56,C20,King's Pawn Game: Napoleon Attack
1307,1246,31,resign,white,61,C20,King's Pawn Game: Napoleon Attack
1296,1298,97,resign,white,2,C20,King's Pawn Game: Napoleon Attack
1127,1296,29,mate,white,169,C20,King's Pawn Game: Napoleon Attack
1134,1023,99,mate,white,111,C20,King's Pawn Game: Napoleon Attack
1707,1542,29,resign,white,165,C20,King's Pawn Game: Napoleon Attack
1697,1606,65,mate,white,91,C20,King's Pawn Game: Napoleon Attack
1621,1475,83,mate,white,146,C20,King's Pawn Game: Napoleon Attack
1500,1371,45,resign,white,129,C20,King's Pawn Game: Napoleon Attack
1451,1198,13,mate,white,253,C20,King's Pawn Game: Napoleon Attack
1511,1526,35,mate,white,15,C20,King's Pawn Game: Napoleon Attack
1375,1385,48,resign,white,10,C20,King's Pawn Game: Napoleon Attack
1350,1500,7,mate,white,150,C20,King's Pawn Game: Napoleon Attack
1940,1327,39,mate,white,613,B00,King's Pawn Game: Nimzowitsch Defense
1162,1319,28,resign,white,157,B00,King's Pawn Game: Nimzowitsch Defense
1652,1038,77,mate,white,614,B00,King's Pawn Game: Nimzowitsch Defense
1845,1638,59,mate,white,207,B00,King's Pawn Game: Nimzowitsch Defense
1470,1090,19,mate,white,380,B00,King's Pawn Game: Nimzowitsch Defense
1612,1556,51,resign,white,56,B00,King's Pawn Game: Nimzowitsch Defense
1287,1278,53,mate,white,9,B00,King's Pawn Game: Nimzowitsch Defense
1351,1116,37,mate,white,235,B00,King's Pawn Game: Nimzowitsch Defense
1403,1388,8,resign,white,15,B00,King's Pawn Game: Nimzowitsch Defense
1500,1569,33,resign,white,69,C44,King's Pawn Game: Tayler Opening
1352,1629,137,mate,white,277,C44,King's Pawn Game: Tayler Opening
1580,1590,29,resign,white,10,C44,King's Pawn Game: Tayler Opening
1345,1296,37,resign,white,49,C20,King's Pawn Game: Tortoise Opening
1445,1649,141,mate,white,204,C20,King's Pawn Game: Tortoise Opening
1445,1649,93,resign,white,204,C20,King's Pawn Game: Tortoise Opening
1127,1044,101,time,white,83,C20,King's Pawn Game: Wayward Queen Attack
1348,1308,67,resign,white,40,C20,King's Pawn Game: Wayward Queen Attack
1191,1598,29,mate,white,407,C20,King's Pawn Game: Wayward Queen Attack
1112,1109,19,resign,white,3,C20,King's Pawn Game: Wayward Queen Attack
1264,1315,131,time,white,51,C20,King's Pawn Game: Wayward Queen Attack
1190,1052,61,time,white,138,C20,King's Pawn Game: Wayward Queen Attack
1479,1400,53,mate,white,79,C20,King's Pawn Game: Wayward Queen Attack
1175,1142,13,resign,white,33,C20,King's Pawn Game: Wayward Queen Attack
963,975,89,resign,white,12,C20,King's Pawn Game: Wayward Queen Attack
1718,1215,11,mate,white,503,C20,King's Pawn Game: Wayward Queen Attack
1228,1292,21,mate,white,64,C20,King's Pawn Game: Wayward Queen Attack
1329,1215,7,resign,white,114,C20,King's Pawn Game: Wayward Queen Attack
958,1274,7,mate,white,316,C20,King's Pawn Game: Wayward Queen Attack
1551,1142,91,mate,white,409,C20,King's Pawn Game: Wayward Queen Attack
1470,1039,41,resign,white,431,C20,King's Pawn Game: Wayward Queen Attack
1546,1282,157,mate,white,264,C20,King's Pawn Game: Wayward Queen Attack
1573,1271,113,resign,white,302,C20,King's Pawn Game: Wayward Queen Attack
1569,1276,9,mate,white,293,C20,King's Pawn Game: Wayward Queen Attack
1381,1163,129,mate,white,218,C20,King's Pawn Game: Wayward Queen Attack
1939,1167,37,resign,white,772,C20,King's Pawn Game: Wayward Queen Attack
1264,1289,29,mate,white,25,C20,King's Pawn Game: Wayward Queen Attack
1361,1373,113,mate,white,12,C20,King's Pawn Game: Wayward Queen Attack
1511,1309,33,mate,white,202,C20,King's Pawn Game: Wayward Queen Attack
1359,1532,89,mate,white,173,C20,King's Pawn Game: Wayward Queen Attack
1476,1362,97,mate,white,114,C20,King's Pawn Game: Wayward Queen Attack
1422,1065,9,resign,white,357,C20,King's Pawn Game: Wayward Queen Attack
1341,1421,12,resign,white,80,C20,King's Pawn Game: Wayward Queen Attack
1360,1388,36,resign,white,28,C20,King's Pawn Game: Wayward Queen Attack
1353,1148,7,resign,white,205,C20,King's Pawn Game: Wayward Queen Attack
1299,991,20,resign,white,308,C20,King's Pawn Game: Wayward Queen Attack
1385,1274,141,resign,white,111,C20,King's Pawn Game: Wayward Queen Attack
1417,1446,57,resign,white,29,C20,King's Pawn Game: Wayward Queen Attack
971,1046,60,resign,white,75,C20,King's Pawn Game: Wayward Queen Attack
1855,1675,89,resign,white,180,C20,King's Pawn Game: Wayward Queen Attack
1375,1389,53,resign,white,14,C20,King's Pawn Game: Wayward Queen Attack |  Kiddie Countergambit
1455,1506,41,resign,white,51,C20,King's Pawn Game: Wayward Queen Attack |  Kiddie Countergambit
1285,1400,41,mate,white,115,C20,King's Pawn Game: Wayward Queen Attack |  Kiddie Countergambit
1288,1257,57,mate,white,31,C20,King's Pawn Game: Wayward Queen Attack |  Kiddie Countergambit
1733,1226,17,mate,white,507,C20,King's Pawn Game: Wayward Queen Attack |  Kiddie Countergambit
1316,1237,35,mate,white,79,C20,King's Pawn Game: Wayward Queen Attack |  Kiddie Countergambit
1464,1432,91,resign,white,32,C20,King's Pawn Game: Wayward Queen Attack |  Kiddie Countergambit
1434,1724,33,resign,white,290,C20,King's Pawn Game: Wayward Queen Attack |  Kiddie Countergambit
1540,1169,39,resign,white,371,C20,King's Pawn Game: Wayward Queen Attack |  Kiddie Countergambit
1429,1282,17,mate,white,147,C20,King's Pawn Game: Wayward Queen Attack |  Kiddie Countergambit
1433,1558,85,mate,white,125,C20,King's Pawn Game: Wayward Queen Attack |  Kiddie Countergambit
1300,1405,87,resign,white,105,C20,King's Pawn Opening: 2.b3
1581,1601,89,resign,white,20,C20,King's Pawn Opening: 2.b3
1421,1696,57,resign,white,275,C20,King's Pawn Opening: 2.b3
1346,1552,49,mate,white,206,C40,Latvian Gambit
1721,1857,63,resign,white,136,C40,Latvian Gambit Accepted
1354,1347,59,mate,white,7,C40,Latvian Gambit Accepted
2352,2366,74,resign,white,14,C40,Latvian Gambit Accepted |  Main Line
1424,1355,107,resign,white,69,C40,Latvian Gambit: Mason Countergambit
1492,1456,27,mate,white,36,C40,Latvian Gambit: Mlotkowski Variation
1764,1500,11,mate,white,264,B00,Lemming Defense
1507,1473,127,mate,white,34,B00,Lemming Defense
1500,987,9,mate,white,513,B00,Lemming Defense
1507,1418,43,mate,white,89,A48,London System
1467,1530,51,resign,white,63,A48,London System
1325,1375,37,resign,white,50,A48,London System
1261,1237,51,resign,white,24,A00,Mieses Opening
1463,1432,42,resign,white,31,A00,Mieses Opening
1472,1564,61,resign,white,92,A00,Mieses Opening
856,1541,57,mate,white,685,A00,Mieses Opening
1152,1206,23,resign,white,54,A00,Mieses Opening
1295,1381,11,resign,white,86,A00,Mieses Opening
1294,1334,49,resign,white,40,A00,Mieses Opening
1375,1606,36,resign,white,231,A00,Mieses Opening
1169,1448,43,mate,white,279,A00,Mieses Opening
1307,1314,75,resign,white,7,A00,Mieses Opening: Reversed Rat
1415,1484,63,mate,white,69,A40,Mikenas Defense
1137,1324,59,mate,white,187,A40,Mikenas Defense
1338,1314,45,mate,white,24,A40,Mikenas Defense
1433,1272,53,mate,white,161,A40,Mikenas Defense
1245,1284,47,mate,white,39,A40,Mikenas Defense: Cannstatter Variation
1839,1229,27,resign,white,610,A40,Mikenas Defense: Cannstatter Variation
1567,1573,49,resign,white,6,A40,Modern Defense
1212,1212,85,mate,white,0,B06,Modern Defense
1453,1496,29,mate,white,43,B06,Modern Defense
1336,1292,73,resign,white,44,A40,Modern Defense
1870,1412,77,mate,white,458,A40,Modern Defense
798,1157,23,resign,white,359,B06,Modern Defense
1886,1737,45,resign,white,149,A40,Modern Defense
1304,1226,63,mate,white,78,B06,Modern Defense
1114,998,30,resign,white,116,B06,Modern Defense
1301,1587,89,mate,white,286,B06,Modern Defense
1292,1622,103,mate,white,330,B06,Modern Defense
1874,1876,141,mate,white,2,B06,Modern Defense
1662,1315,83,resign,white,347,B06,Modern Defense
1204,1187,78,resign,white,17,B06,Modern Defense
1229,1215,29,resign,white,14,B06,Modern Defense
1242,1162,77,resign,white,80,B06,Modern Defense
1451,1144,77,resign,white,307,B06,Modern Defense
1342,1163,23,resign,white,179,B06,Modern Defense
1397,1183,53,resign,white,214,A40,Modern Defense
1443,1219,95,mate,white,224,B06,Modern Defense
1904,1938,53,resign,white,34,A40,Modern Defense
1173,1336,13,mate,white,163,B06,Modern Defense
1845,1189,25,time,white,656,B06,Modern Defense
1775,1379,3,resign,white,396,A40,Modern Defense
1769,1383,113,mate,white,386,A40,Modern Defense
1734,1738,143,mate,white,4,B06,Modern Defense
1649,1447,95,mate,white,202,B06,Modern Defense
1824,1817,47,mate,white,7,B06,Modern Defense
1544,1332,53,resign,white,212,A40,Modern Defense
1069,1295,69,mate,white,226,A40,Modern Defense
1372,1456,95,resign,white,84,B06,Modern Defense
1433,1509,24,resign,white,76,A40,Modern Defense
1208,936,19,resign,white,272,B06,Modern Defense
1439,1454,11,mate,white,15,B06,Modern Defense
1952,1507,37,resign,white,445,B06,Modern Defense
2432,2213,99,resign,white,219,A42,Modern Defense: Averbakh System |  Kotov Variation
2248,2015,87,resign,white,233,A40,Modern Defense: Beefeater Variation
1428,1510,56,resign,white,82,B06,Modern Defense: Standard Defense
1667,1668,58,resign,white,1,B06,Modern Defense: Three Pawns Attack
1152,1471,37,mate,white,319,B06,Modern Defense: Three Pawns Attack
1283,1516,39,mate,white,233,B06,Modern Defense: Two Knights Variation
2227,2107,57,resign,white,120,D74,Neo-Gruenfeld Defense: Delayed Exchange Variation
1349,1403,57,mate,white,54,E20,Nimzo-Indian Defense
1718,1711,59,mate,white,7,E20,Nimzo-Indian Defense
1979,1800,69,resign,white,179,E20,Nimzo-Indian Defense
1798,1729,153,mate,white,69,E20,Nimzo-Indian Defense #2
1645,1686,45,resign,white,41,E20,Nimzo-Indian Defense #2
1468,1260,63,mate,white,208,E20,Nimzo-Indian Defense #2
1696,1623,41,time,white,73,E20,Nimzo-Indian Defense #2
1852,1748,24,resign,white,104,E32,Nimzo-Indian Defense: Classical Variation
1755,1792,95,time,white,37,E32,Nimzo-Indian Defense: Classical Variation
1577,1594,50,resign,white,17,E38,Nimzo-Indian Defense: Classical Variation |  Berlin Variation
2116,2252,95,mate,white,136,E34,Nimzo-Indian Defense: Classical Variation |  Noa Variation
1690,1701,66,resign,white,11,E33,Nimzo-Indian Defense: Classical Variation |  Zurich Variation
1686,2166,85,resign,white,480,E42,Nimzo-Indian Defense: Huebner Variation |  Rubinstein Variation
1846,1719,69,resign,white,127,E30,Nimzo-Indian Defense: Leningrad Variation
1858,1920,93,mate,white,62,E30,Nimzo-Indian Defense: Leningrad Variation
1761,1808,109,mate,white,47,E30,Nimzo-Indian Defense: Leningrad Variation
2223,2032,29,resign,white,191,E40,Nimzo-Indian Defense: Normal Line
1740,1920,97,mate,white,180,E50,Nimzo-Indian Defense: Normal Variation |  Huebner Deferred
1735,1929,41,resign,white,194,E50,Nimzo-Indian Defense: Normal Variation |  Huebner Deferred
2193,1882,111,resign,white,311,E51,Nimzo-Indian Defense: Normal Variation |  Ragozin Variation
1828,2012,65,resign,white,184,E51,Nimzo-Indian Defense: Normal Variation |  Ragozin Variation
2367,2234,71,resign,white,133,E54,Nimzo-Indian Defense: Panov Attack |  Main Line
1903,1512,37,resign,white,391,E20,Nimzo-Indian Defense: Ragozin Variation
2300,2041,29,resign,white,259,E20,Nimzo-Indian Defense: Ragozin Variation
1440,1443,50,resign,white,3,E20,Nimzo-Indian Defense: Ragozin Variation
1441,1331,46,resign,white,110,E20,Nimzo-Indian Defense: Ragozin Variation
1130,1048,77,mate,white,82,E20,Nimzo-Indian Defense: Ragozin Variation
1836,1500,77,mate,white,336,E20,Nimzo-Indian Defense: Ragozin Variation
2263,2006,41,resign,white,257,E21,Nimzo-Indian Defense: Three Knights Variation
2082,1500,52,resign,white,582,E21,Nimzo-Indian Defense: Three Knights Variation
1959,2028,81,resign,white,69,A01,Nimzo-Larsen Attack
1728,1859,73,mate,white,131,A01,Nimzo-Larsen Attack
1765,1234,2,resign,white,531,A01,Nimzo-Larsen Attack
1654,1345,3,resign,white,309,A01,Nimzo-Larsen Attack
1765,1234,2,resign,white,531,A01,Nimzo-Larsen Attack
1654,1345,3,resign,white,309,A01,Nimzo-Larsen Attack
1913,1643,33,mate,white,270,A01,Nimzo-Larsen Attack
1506,1109,37,resign,white,397,A01,Nimzo-Larsen Attack
1721,1500,23,resign,white,221,A01,Nimzo-Larsen Attack
1327,1305,61,time,white,22,A01,Nimzo-Larsen Attack
1640,1692,36,resign,white,52,A01,Nimzo-Larsen Attack
1569,1569,39,mate,white,0,A01,Nimzo-Larsen Attack: Classical Variation
1951,2049,119,mate,white,98,A01,Nimzo-Larsen Attack: Classical Variation
1713,1609,105,mate,white,104,A01,Nimzo-Larsen Attack: Classical Variation
1312,1298,67,resign,white,14,A01,Nimzo-Larsen Attack: Classical Variation
1625,1619,77,time,white,6,A01,Nimzo-Larsen Attack: Classical Variation
1849,1903,69,resign,white,54,A01,Nimzo-Larsen Attack: Classical Variation
1734,1784,45,resign,white,50,A01,Nimzo-Larsen Attack: Classical Variation
1960,1868,161,mate,white,92,A01,Nimzo-Larsen Attack: English Variation
1581,1513,45,mate,white,68,A01,Nimzo-Larsen Attack: English Variation
1696,1652,49,resign,white,44,A01,Nimzo-Larsen Attack: English Variation
1663,1705,85,resign,white,42,A01,Nimzo-Larsen Attack: Indian Variation
1138,1266,105,resign,white,128,A01,Nimzo-Larsen Attack: Modern Variation
1820,1814,77,resign,white,6,A01,Nimzo-Larsen Attack: Modern Variation #2
1649,1483,41,mate,white,166,A01,Nimzo-Larsen Attack: Modern Variation #2
1612,1680,87,mate,white,68,A01,Nimzo-Larsen Attack: Modern Variation #2
1816,1820,25,resign,white,4,A01,Nimzo-Larsen Attack: Modern Variation #3
1413,1305,105,resign,white,108,A01,Nimzo-Larsen Attack: Modern Variation #4
1419,1437,83,resign,white,18,A01,Nimzo-Larsen Attack: Modern Variation #4
2022,2148,73,time,white,126,A01,Nimzo-Larsen Attack: Modern Variation #4
1580,1520,53,time,white,60,A01,Nimzo-Larsen Attack: Modern Variation #4
1935,1999,45,resign,white,64,A01,Nimzo-Larsen Attack: Modern Variation #4
1285,1279,7,mate,white,6,B00,Nimzowitsch Defense
1539,1510,61,time,white,29,B00,Nimzowitsch Defense
1315,1205,11,mate,white,110,B00,Nimzowitsch Defense
1298,1198,93,mate,white,100,B00,Nimzowitsch Defense
1221,1105,15,mate,white,116,B00,Nimzowitsch Defense
1199,1123,11,mate,white,76,B00,Nimzowitsch Defense
1122,1160,13,mate,white,38,B00,Nimzowitsch Defense
1299,1176,11,mate,white,123,B00,Nimzowitsch Defense
1720,1245,35,time,white,475,B00,Nimzowitsch Defense
1612,1039,43,mate,white,573,B00,Nimzowitsch Defense
1297,1024,89,mate,white,273,B00,Nimzowitsch Defense
1702,1500,40,resign,white,202,B00,Nimzowitsch Defense
1934,2045,83,resign,white,111,B00,Nimzowitsch Defense
1558,1500,22,resign,white,58,B00,Nimzowitsch Defense
1531,1190,75,mate,white,341,B00,Nimzowitsch Defense
1560,1686,111,time,white,126,B00,Nimzowitsch Defense |  Declined Variation
1729,1553,59,resign,white,176,B00,Nimzowitsch Defense |  Declined Variation
1396,1379,19,mate,white,17,B00,Nimzowitsch Defense |  Declined Variation
1548,1482,69,mate,white,66,B00,Nimzowitsch Defense |  Declined Variation
1329,1358,89,resign,white,29,B00,Nimzowitsch Defense: Breyer Variation
1508,1555,53,resign,white,47,B00,Nimzowitsch Defense: Breyer Variation
1576,1635,67,resign,white,59,B00,Nimzowitsch Defense: Breyer Variation
1210,1191,35,mate,white,19,B00,Nimzowitsch Defense: Franco-Nimzowitsch Variation
1683,1097,51,resign,white,586,B00,Nimzowitsch Defense: Franco-Nimzowitsch Variation
1425,1099,27,resign,white,326,B00,Nimzowitsch Defense: Franco-Nimzowitsch Variation
1627,1627,137,time,white,0,B00,Nimzowitsch Defense: Franco-Nimzowitsch Variation
2000,1331,15,mate,white,669,B00,Nimzowitsch Defense: Franco-Nimzowitsch Variation
1498,1500,35,mate,white,2,B00,Nimzowitsch Defense: Franco-Nimzowitsch Variation
1149,1159,49,mate,white,10,B00,Nimzowitsch Defense: Kennedy Variation
1709,1716,75,time,white,7,B00,Nimzowitsch Defense: Kennedy Variation |  Linksspringer Variation
1711,1645,39,resign,white,66,B00,Nimzowitsch Defense: Kennedy Variation |  Linksspringer Variation
1400,1500,61,mate,white,100,B00,Nimzowitsch Defense: Kennedy Variation |  Linksspringer Variation
1419,1309,37,mate,white,110,B00,Nimzowitsch Defense: Kennedy Variation |  Linksspringer Variation
1169,1133,27,time,white,36,B00,Nimzowitsch Defense: Kennedy Variation |  Linksspringer Variation
1536,1500,147,mate,white,36,B00,Nimzowitsch Defense: Kennedy Variation |  Linksspringer Variation
945,964,55,resign,white,19,B00,Nimzowitsch Defense: Kennedy Variation |  Linksspringer Variation
1560,1440,31,mate,white,120,B00,Nimzowitsch Defense: Kennedy Variation |  Linksspringer Variation
1542,1469,67,resign,white,73,B00,Nimzowitsch Defense: Kennedy Variation |  Linksspringer Variation
1415,1259,45,mate,white,156,B00,Nimzowitsch Defense: Kennedy Variation |  Linksspringer Variation
1650,1720,37,mate,white,70,B00,Nimzowitsch Defense: Kennedy Variation |  Linksspringer Variation
2003,1808,91,resign,white,195,B00,Nimzowitsch Defense: Kennedy Variation |  Linksspringer Variation
1430,1274,17,mate,white,156,B00,Nimzowitsch Defense: Kennedy Variation |  Linksspringer Variation
1343,1165,75,mate,white,178,B00,Nimzowitsch Defense: Kennedy Variation |  Paulsen Attack
1179,1197,19,mate,white,18,B00,Nimzowitsch Defense: Kennedy Variation |  Paulsen Attack
1360,1332,31,resign,white,28,B00,Nimzowitsch Defense: Lean Variation |  Colorado Counter Accepted
1518,1709,35,resign,white,191,B00,Nimzowitsch Defense: Lean Variation |  Colorado Counter Accepted
1107,961,95,mate,white,146,B00,Nimzowitsch Defense: Mikenas Variation
1352,1222,57,resign,white,130,B00,Nimzowitsch Defense: Mikenas Variation
1335,1371,151,mate,white,36,B00,Nimzowitsch Defense: Pseudo-Spanish Variation
1265,1957,31,resign,white,692,B00,Nimzowitsch Defense: Scandinavian Variation |  Advance Variation
1391,875,57,mate,white,516,B00,Nimzowitsch Defense: Scandinavian Variation |  Advance Variation
1303,1321,59,mate,white,18,B00,Nimzowitsch Defense: Scandinavian Variation |  Advance Variation
1382,1170,77,resign,white,212,B00,Nimzowitsch Defense: Scandinavian Variation |  Advance Variation
1549,1439,39,resign,white,110,B00,Nimzowitsch Defense: Scandinavian Variation |  Advance Variation
1589,1227,75,resign,white,362,B00,Nimzowitsch Defense: Scandinavian Variation |  Advance Variation
1267,1233,67,mate,white,34,B00,Nimzowitsch Defense: Scandinavian Variation |  Advance Variation
1802,1367,69,mate,white,435,B00,Nimzowitsch Defense: Scandinavian Variation |  Advance Variation
1147,1121,33,mate,white,26,B00,Nimzowitsch Defense: Scandinavian Variation |  Bogoljubov Variation
1720,1406,83,resign,white,314,B00,Nimzowitsch Defense: Scandinavian Variation |  Bogoljubov Variation
1884,1815,65,resign,white,69,B00,Nimzowitsch Defense: Scandinavian Variation |  Exchange Variation
1435,1500,21,mate,white,65,B00,Nimzowitsch Defense: Scandinavian Variation |  Exchange Variation
1949,2077,107,time,white,128,B00,Nimzowitsch Defense: Scandinavian Variation |  Exchange Variation
1727,1711,11,resign,white,16,B00,Nimzowitsch Defense: Scandinavian Variation |  Exchange Variation
1355,1302,107,mate,white,53,B00,Nimzowitsch Defense: Scandinavian Variation |  Exchange Variation
1265,1500,53,resign,white,235,B00,Nimzowitsch Defense: Williams Variation
1757,1896,50,resign,white,139,B00,Nimzowitsch Defense: Williams Variation
1997,1852,33,resign,white,145,A06,Nimzowitsch-Larsen Attack
1500,1370,41,mate,white,130,A06,Nimzowitsch-Larsen Attack
1853,1525,71,mate,white,328,A06,Nimzowitsch-Larsen Attack
1662,1542,147,mate,white,120,A43,Old Benoni Defense
2034,2002,67,resign,white,32,A43,Old Benoni Defense
1614,1318,44,resign,white,296,A43,Old Benoni Defense
1791,1683,29,resign,white,108,A43,Old Benoni Defense
1607,1463,49,resign,white,144,A43,Old Benoni Defense
1324,1321,27,mate,white,3,A43,Old Benoni Defense #2
1733,1199,69,mate,white,534,A41,Old Indian Defense
1417,1326,21,resign,white,91,A53,Old Indian Defense
1661,1680,63,resign,white,19,A53,Old Indian Defense
2042,1982,41,resign,white,60,A53,Old Indian Defense
1545,1497,125,resign,white,48,A41,Old Indian Defense
1528,1708,55,resign,white,180,A53,Old Indian Defense
1694,1545,123,resign,white,149,A41,Old Indian Defense
1537,1330,75,mate,white,207,A53,Old Indian Defense
2191,2077,41,resign,white,114,A54,Old Indian Defense: Two Knights Variation
1728,1576,87,time,white,152,A53,Old Indian: Czech Variation |  with Nc3
1497,1730,57,resign,white,233,B00,Owen Defense
1590,1373,19,mate,white,217,B00,Owen Defense
1476,1367,15,mate,white,109,B00,Owen Defense
1460,1386,65,mate,white,74,B00,Owen Defense
1905,1852,49,resign,white,53,B00,Owen Defense
1266,1130,37,resign,white,136,B00,Owen Defense
1885,1607,99,mate,white,278,B00,Owen Defense
1395,1273,9,mate,white,122,B00,Owen Defense
1410,1300,47,mate,white,110,B00,Owen Defense
1500,1261,113,mate,white,239,B00,Owen Defense
1504,1500,63,mate,white,4,B00,Owen Defense
1709,1291,35,resign,white,418,B00,Owen Defense
979,1043,93,time,white,64,B00,Owen Defense
1532,1546,119,mate,white,14,B00,Owen Defense
1548,1334,48,resign,white,214,B00,Owen Defense
1301,1143,85,mate,white,158,B00,Owen Defense
1366,1402,53,mate,white,36,B00,Owen Defense
2007,2005,29,resign,white,2,B00,Owen Defense
1414,1500,23,mate,white,86,B00,Owen Defense
1441,1158,28,resign,white,283,B00,Owen Defense
1903,1898,21,mate,white,5,B00,Owen Defense
1515,1412,3,resign,white,103,B00,Owen Defense
1640,1436,61,resign,white,204,B00,Owen Defense
1698,1612,23,resign,white,86,B00,Owen Defense
1987,1456,63,mate,white,531,B00,Owen Defense
1913,1463,63,mate,white,450,B00,Owen Defense
1154,920,39,resign,white,234,B00,Owen Defense
1543,1500,27,resign,white,43,B00,Owen Defense
1369,1074,33,mate,white,295,B00,Owen Defense
1500,1435,45,resign,white,65,A45,Paleface Attack
2288,2148,45,resign,white,140,C42,Petrov's Defense
1209,1261,69,mate,white,52,C42,Petrov's Defense
1454,1384,47,time,white,70,C42,Petrov's Defense
1259,1319,35,mate,white,60,C42,Petrov's Defense
1545,1405,67,mate,white,140,C42,Petrov's Defense #2
1416,1216,63,mate,white,200,C42,Petrov's Defense #2
1519,1740,77,resign,white,221,C42,Petrov's Defense #2
1482,1525,63,time,white,43,C42,Petrov's Defense #2
1193,1360,63,resign,white,167,C42,Petrov's Defense #2
1142,1138,48,resign,white,4,C42,Petrov's Defense #3
1291,1295,31,mate,white,4,C43,Petrov: Modern Attack
1523,1469,95,mate,white,54,C41,Philidor Defense
1726,1388,81,time,white,338,C41,Philidor Defense
1378,1361,49,mate,white,17,C41,Philidor Defense
1534,1678,33,mate,white,144,C41,Philidor Defense
1154,974,27,resign,white,180,C41,Philidor Defense
2104,1344,31,mate,white,760,C41,Philidor Defense
1904,1544,27,mate,white,360,C41,Philidor Defense
1390,1423,129,time,white,33,C41,Philidor Defense
1335,1355,13,mate,white,20,C41,Philidor Defense
1666,1044,171,mate,white,622,C41,Philidor Defense
1113,1122,27,mate,white,9,C41,Philidor Defense
1474,1201,65,resign,white,273,C41,Philidor Defense
1546,1532,145,mate,white,14,C41,Philidor Defense
1853,1766,45,resign,white,87,C41,Philidor Defense
1500,1319,51,mate,white,181,C41,Philidor Defense
1470,1499,109,mate,white,29,C41,Philidor Defense
1391,1448,143,resign,white,57,C41,Philidor Defense
1183,1413,101,time,white,230,C41,Philidor Defense
1812,1691,95,mate,white,121,C41,Philidor Defense
1847,1707,73,resign,white,140,C41,Philidor Defense
1982,1644,53,mate,white,338,C41,Philidor Defense
1720,1383,15,mate,white,337,C41,Philidor Defense
1716,1309,49,resign,white,407,C41,Philidor Defense
1451,1135,71,mate,white,316,C41,Philidor Defense
1943,1839,103,resign,white,104,C41,Philidor Defense
1909,1887,97,resign,white,22,C41,Philidor Defense
1954,1902,159,time,white,52,C41,Philidor Defense
2177,1858,35,resign,white,319,C41,Philidor Defense
1470,1395,47,mate,white,75,C41,Philidor Defense
1377,1351,103,mate,white,26,C41,Philidor Defense #2
1627,1496,59,resign,white,131,C41,Philidor Defense #2
1291,1262,87,mate,white,29,C41,Philidor Defense #2
1282,1492,57,mate,white,210,C41,Philidor Defense #2
1301,1616,95,time,white,315,C41,Philidor Defense #2
1351,1357,55,time,white,6,C41,Philidor Defense #2
1719,1677,135,mate,white,42,C41,Philidor Defense #2
1718,1436,37,resign,white,282,C41,Philidor Defense #2
1393,1404,94,resign,white,11,C41,Philidor Defense #2
1468,1358,69,resign,white,110,C41,Philidor Defense #2
1093,1119,121,mate,white,26,C41,Philidor Defense #2
1834,1930,21,mate,white,96,C41,Philidor Defense #2
1349,1306,115,mate,white,43,C41,Philidor Defense #2
1361,1293,41,mate,white,68,C41,Philidor Defense #2
1553,1485,57,resign,white,68,C41,Philidor Defense #2
1478,1295,61,mate,white,183,C41,Philidor Defense #2
1374,1347,95,mate,white,27,C41,Philidor Defense #2
1308,1330,35,mate,white,22,C41,Philidor Defense #2
1688,1388,58,resign,white,300,C41,Philidor Defense #2
1805,1273,43,resign,white,532,C41,Philidor Defense #2
1800,1282,113,mate,white,518,C41,Philidor Defense #2
1508,1509,23,mate,white,1,C41,Philidor Defense #2
1506,1605,69,time,white,99,C41,Philidor Defense #2
1553,1008,23,resign,white,545,C41,Philidor Defense #2
1810,1933,147,mate,white,123,C41,Philidor Defense #2
1289,1199,51,resign,white,90,C41,Philidor Defense #2
1330,1278,61,mate,white,52,C41,Philidor Defense #2
1399,1386,101,resign,white,13,C41,Philidor Defense #2
1906,1869,23,resign,white,37,C41,Philidor Defense #2
1329,1061,27,resign,white,268,C41,Philidor Defense #2
1196,1112,115,mate,white,84,C41,Philidor Defense #2
2192,1357,55,resign,white,835,C41,Philidor Defense #2
1372,1408,67,resign,white,36,C41,Philidor Defense #3
1694,1825,89,time,white,131,C41,Philidor Defense #3
1683,1717,67,resign,white,34,C41,Philidor Defense #3
1894,1506,89,resign,white,388,C41,Philidor Defense #3
1569,1298,99,mate,white,271,C41,Philidor Defense #3
1406,1338,93,time,white,68,C41,Philidor Defense #3
1353,1364,60,resign,white,11,C41,Philidor Defense #3
1743,1320,23,mate,white,423,C41,Philidor Defense #3
1309,1213,41,resign,white,96,C41,Philidor Defense #3
1700,982,81,mate,white,718,C41,Philidor Defense #3
1384,1380,35,resign,white,4,C41,Philidor Defense #3
1502,1695,118,resign,white,193,C41,Philidor Defense #3
1371,1284,23,resign,white,87,C41,Philidor Defense #3
1147,1108,13,mate,white,39,C41,Philidor Defense #3
1846,1947,57,resign,white,101,C41,Philidor Defense #3
1250,1475,47,mate,white,225,C41,Philidor Defense #3
1500,1332,43,mate,white,168,C41,Philidor Defense #3
1391,1342,33,mate,white,49,C41,Philidor Defense #3
1445,1338,17,mate,white,107,C41,Philidor Defense #3
1347,1374,61,mate,white,27,C41,Philidor Defense #3
1629,1713,23,mate,white,84,C41,Philidor Defense #3
1617,1343,41,resign,white,274,C41,Philidor Defense #3
1623,1566,23,resign,white,57,C41,Philidor Defense #3
1424,1373,45,mate,white,51,C41,Philidor Defense #3
1385,1362,35,mate,white,23,C41,Philidor Defense #3
1709,1404,17,mate,white,305,C41,Philidor Defense #3
1071,1191,11,resign,white,120,C41,Philidor Defense #3
2108,1623,55,mate,white,485,C41,Philidor Defense #3
1529,1528,81,resign,white,1,C41,Philidor Defense #3
1267,1307,89,mate,white,40,C41,Philidor Defense #3
1449,1529,67,mate,white,80,C41,Philidor Defense #3
2150,1774,81,mate,white,376,C41,Philidor Defense #3
1398,1445,93,resign,white,47,C41,Philidor Defense #3
1960,1857,51,mate,white,103,C41,Philidor Defense #3
2152,1895,41,time,white,257,C41,Philidor Defense #3
2054,1876,65,resign,white,178,C41,Philidor Defense #3
1554,1104,7,resign,white,450,C41,Philidor Defense #3
1605,1352,31,resign,white,253,C41,Philidor Defense #3
1559,1500,65,time,white,59,C41,Philidor Defense #3
1562,1714,51,resign,white,152,C41,Philidor Defense #3
1574,1561,71,time,white,13,C41,Philidor Defense #4
1480,1432,99,mate,white,48,C41,Philidor Defense #4
1470,1521,79,resign,white,51,C41,Philidor Defense #4
2264,1871,55,resign,white,393,C41,Philidor Defense: Exchange Variation
1333,1318,73,mate,white,15,C41,Philidor Defense: Exchange Variation
1662,1656,73,resign,white,6,C41,Philidor Defense: Exchange Variation
2011,1602,45,mate,white,409,C41,Philidor Defense: Exchange Variation
1500,1571,27,resign,white,71,C41,Philidor Defense: Exchange Variation #2
1787,1417,65,mate,white,370,C41,Philidor Defense: Exchange Variation #2
2210,1805,29,resign,white,405,C41,Philidor Defense: Exchange Variation #2
1541,1690,41,mate,white,149,C41,Philidor Defense: Exchange Variation #2
1397,1327,57,resign,white,70,C41,Philidor Defense: Exchange Variation #2
1828,1500,31,mate,white,328,C41,Philidor Defense: Exchange Variation #2
1938,1862,77,resign,white,76,C41,Philidor Defense: Exchange Variation #2
1862,1871,31,mate,white,9,C41,Philidor Defense: Exchange Variation #2
1892,1831,77,resign,white,61,C41,Philidor Defense: Exchange Variation #2
1696,1702,41,time,white,6,C41,Philidor Defense: Exchange Variation #2
1253,1620,45,mate,white,367,C41,Philidor Defense: Exchange Variation #3
1631,1537,107,resign,white,94,C41,Philidor Defense: Hanham Variation
1505,1617,85,resign,white,112,C41,Philidor Defense: Hanham Variation
1689,1690,16,resign,white,1,C41,Philidor Defense: Hanham Variation
1525,1466,29,resign,white,59,C41,Philidor Defense: Lopez Countergambit
1595,1223,41,time,white,372,C41,Philidor Defense: Nimzowitsch Variation #2
1098,1202,38,resign,white,104,C41,Philidor Defense: Nimzowitsch Variation #2
1350,1409,51,resign,white,59,C41,Philidor Defense: Nimzowitsch Variation #2
2014,1610,149,mate,white,404,C41,Philidor Defense: Philidor Countergambit
1749,1726,29,resign,white,23,B07,Pirc Defense
1290,1144,71,time,white,146,B07,Pirc Defense
2447,2005,63,mate,white,442,B07,Pirc Defense #2
1367,1343,35,resign,white,24,B07,Pirc Defense #2
1970,1666,39,resign,white,304,B07,Pirc Defense #2
1655,1709,15,resign,white,54,B07,Pirc Defense #2
1603,1539,45,mate,white,64,B07,Pirc Defense #3
2162,1538,39,resign,white,624,B07,Pirc Defense #3
1532,1400,47,mate,white,132,B07,Pirc Defense #3
1708,1680,23,resign,white,28,B07,Pirc Defense #3
1447,1439,71,resign,white,8,B07,Pirc Defense #4
1614,1711,47,resign,white,97,B07,Pirc Defense #4
1525,1657,41,resign,white,132,B07,Pirc Defense #4
1782,1651,68,resign,white,131,B07,Pirc Defense #4
1700,1635,25,mate,white,65,B07,Pirc Defense #4
1708,1548,79,resign,white,160,B07,Pirc Defense #4
1642,1055,71,mate,white,587,B07,Pirc Defense #4
1236,1285,69,resign,white,49,B07,Pirc Defense #4
2081,2243,43,resign,white,162,B07,Pirc Defense #4
1500,1547,33,resign,white,47,B07,Pirc Defense #4
1254,1068,27,resign,white,186,B07,Pirc Defense #4
1543,1006,19,resign,white,537,B07,Pirc Defense #4
1714,1479,119,mate,white,235,B07,Pirc Defense #4
1481,1235,105,resign,white,246,B07,Pirc Defense #4
1233,1251,81,resign,white,18,B07,Pirc Defense #4
1735,1763,34,resign,white,28,B07,Pirc Defense #4
1266,1307,54,resign,white,41,B07,Pirc Defense #4
1425,1481,99,mate,white,56,B07,Pirc Defense #4
1521,1507,57,time,white,14,B07,Pirc Defense #4
1352,1444,141,mate,white,92,B07,Pirc Defense #4
1328,1215,62,resign,white,113,B07,Pirc Defense #4
1854,1871,83,resign,white,17,B07,Pirc Defense #5
2065,1879,53,resign,white,186,B07,Pirc Defense #5
1297,1346,5,resign,white,49,B07,Pirc Defense #5
1993,1609,29,resign,white,384,B07,Pirc Defense #5
1452,1210,69,mate,white,242,B07,Pirc Defense #5
1511,1602,31,resign,white,91,B07,Pirc Defense #5
1728,1290,59,mate,white,438,B07,Pirc Defense #5
1619,1501,99,time,white,118,B07,Pirc Defense #5
1270,1277,43,mate,white,7,B07,Pirc Defense #5
1925,1839,59,mate,white,86,B07,Pirc Defense #5
1638,1500,27,mate,white,138,B07,Pirc Defense #5
1618,1579,43,mate,white,39,B07,Pirc Defense #5
1467,1563,39,resign,white,96,B09,Pirc Defense: Austrian Attack
2068,1982,37,resign,white,86,B09,Pirc Defense: Austrian Attack |  Unzicker Attack
2175,1936,70,resign,white,239,B09,Pirc Defense: Austrian Attack |  Weiss Variation
2230,1666,59,resign,white,564,B08,Pirc Defense: Classical Variation
1913,1874,29,resign,white,39,B08,Pirc Defense: Classical Variation
1713,1809,77,mate,white,96,B08,Pirc Defense: Classical Variation
1571,1612,69,resign,white,41,B08,Pirc Defense: Classical Variation
1408,1184,47,mate,white,224,B07,Pirc Defense: Classical Variation #2
1570,1370,59,mate,white,200,B07,Pirc Defense: Classical Variation #2
1803,1934,55,resign,white,131,B08,Pirc Defense: Classical Variation |  Quiet System |  Czech Defense
1890,1639,63,resign,white,251,B08,Pirc Defense: Classical Variation |  Schlechter Variation
1791,1983,53,resign,white,192,B08,Pirc Defense: Classical Variation |  Schlechter Variation
1914,1788,51,resign,white,126,B08,Pirc Defense: Classical Variation |  Schlechter Variation
1332,1500,89,mate,white,168,A40,Polish Defense
1859,1946,87,resign,white,87,A40,Polish Defense
1281,1047,43,resign,white,234,A40,Polish Defense
1790,1874,65,resign,white,84,A00,Polish Opening
1444,1465,43,resign,white,21,A00,Polish Opening
1902,1811,38,resign,white,91,A00,Polish Opening
1674,1095,5,resign,white,579,A00,Polish Opening
1368,1334,49,resign,white,34,A00,Polish Opening
1489,1394,35,mate,white,95,A00,Polish Opening
1588,1996,31,resign,white,408,A00,Polish Opening
1697,1673,17,resign,white,24,A00,Polish Opening
1638,1631,18,resign,white,7,A00,Polish Opening
1812,1811,69,resign,white,1,A00,Polish Opening: Czech Defense
1428,1073,97,mate,white,355,A00,Polish Opening: Czech Defense
2067,2243,29,resign,white,176,A00,Polish Opening: Queen's Indian Variation
1805,1749,41,resign,white,56,A04,Polish Opening: Zukertort System
1687,1641,31,resign,white,46,C44,Ponziani Opening
1903,1864,67,resign,white,39,C44,Ponziani Opening
2198,1519,67,resign,white,679,C44,Ponziani Opening
1324,1329,103,resign,white,5,C44,Ponziani Opening: Jaenisch Counterattack
1934,1518,71,resign,white,416,C44,Ponziani Opening: Jaenisch Counterattack
1874,1851,55,resign,white,23,C44,Ponziani Opening: Jaenisch Counterattack
1651,1385,119,resign,white,266,C20,Portuguese Opening
1306,1307,39,mate,white,1,C20,Portuguese Opening
1055,965,27,resign,white,90,C20,Portuguese Opening
1599,1744,145,mate,white,145,C20,Portuguese Opening
1395,1500,43,mate,white,105,C20,Portuguese Opening
1682,1670,31,mate,white,12,D06,Queen's Gambit
1799,1711,41,resign,white,88,D06,Queen's Gambit
1560,1160,3,resign,white,400,D06,Queen's Gambit
1371,1576,45,resign,white,205,D20,Queen's Gambit Accepted
1466,1439,39,resign,white,27,D20,Queen's Gambit Accepted
1254,1560,17,mate,white,306,D20,Queen's Gambit Accepted
1421,1190,47,mate,white,231,D20,Queen's Gambit Accepted
1264,1763,103,mate,white,499,D20,Queen's Gambit Accepted
1977,1763,77,mate,white,214,D20,Queen's Gambit Accepted
1323,1449,63,time,white,126,D20,Queen's Gambit Accepted
1758,1160,71,resign,white,598,D20,Queen's Gambit Accepted: Central Variation |  McDonnell Defense
1253,1196,75,mate,white,57,D20,Queen's Gambit Accepted: Central Variation |  McDonnell Defense
1403,1182,95,mate,white,221,D20,Queen's Gambit Accepted: Central Variation |  Modern Defense
1647,1461,67,resign,white,186,D20,Queen's Gambit Accepted: Central Variation |  Modern Defense
1257,1414,77,time,white,157,D20,Queen's Gambit Accepted: Central Variation |  Modern Defense
1445,1431,45,resign,white,14,D20,Queen's Gambit Accepted: Central Variation |  Modern Defense
1412,1305,63,resign,white,107,D20,Queen's Gambit Accepted: Central Variation |  Rubinstein Defense
1696,1824,24,resign,white,128,D24,Queen's Gambit Accepted: Gunsberg Defense |  Prianishenmo Gambit
1651,1466,25,mate,white,185,D21,Queen's Gambit Accepted: Normal Variation
1667,1404,57,mate,white,263,D21,Queen's Gambit Accepted: Normal Variation
1919,2021,51,resign,white,102,D25,Queen's Gambit Accepted: Normal Variation
1740,1485,39,resign,white,255,D26,Queen's Gambit Accepted: Normal Variation |  Traditional System
1746,1487,137,time,white,259,D20,Queen's Gambit Accepted: Old Variation
1290,1367,41,mate,white,77,D20,Queen's Gambit Accepted: Old Variation
1322,1072,39,mate,white,250,D20,Queen's Gambit Accepted: Old Variation
1875,1074,75,mate,white,801,D20,Queen's Gambit Accepted: Old Variation
1547,1567,101,resign,white,20,D20,Queen's Gambit Accepted: Old Variation
1667,1250,97,mate,white,417,D20,Queen's Gambit Accepted: Old Variation
1838,1610,41,mate,white,228,D20,Queen's Gambit Accepted: Old Variation
1813,1874,41,resign,white,61,D20,Queen's Gambit Accepted: Old Variation
1718,1205,119,resign,white,513,D20,Queen's Gambit Accepted: Old Variation
1762,1361,71,resign,white,401,D20,Queen's Gambit Accepted: Old Variation
1700,1673,123,mate,white,27,D20,Queen's Gambit Accepted: Old Variation
2151,2046,125,resign,white,105,D20,Queen's Gambit Accepted: Old Variation
1978,1746,81,mate,white,232,D20,Queen's Gambit Accepted: Old Variation
1615,1731,67,resign,white,116,D20,Queen's Gambit Accepted: Old Variation
1600,1761,39,resign,white,161,D20,Queen's Gambit Accepted: Old Variation
1555,1454,135,mate,white,101,D20,Queen's Gambit Accepted: Old Variation
1555,1576,55,resign,white,21,D20,Queen's Gambit Accepted: Old Variation
1596,1502,19,time,white,94,D20,Queen's Gambit Accepted: Old Variation
1706,1700,57,resign,white,6,D20,Queen's Gambit Accepted: Old Variation
1770,1249,39,mate,white,521,D20,Queen's Gambit Accepted: Old Variation
1773,1785,61,mate,white,12,D20,Queen's Gambit Accepted: Old Variation
1765,1841,123,mate,white,76,D20,Queen's Gambit Accepted: Old Variation
1729,1706,69,mate,white,23,D20,Queen's Gambit Accepted: Old Variation
1743,1504,41,mate,white,239,D20,Queen's Gambit Accepted: Old Variation
1373,1341,41,resign,white,32,D21,Queen's Gambit Accepted: Rosenthal Variation
1500,1500,27,resign,white,0,D21,Queen's Gambit Accepted: Rosenthal Variation
1558,1235,31,resign,white,323,D21,Queen's Gambit Accepted: Rosenthal Variation
2193,1965,13,time,white,228,D21,Queen's Gambit Accepted: Rosenthal Variation
1780,1808,77,resign,white,28,D20,Queen's Gambit Accepted: Saduleto Variation
1578,1521,65,mate,white,57,D20,Queen's Gambit Accepted: Saduleto Variation
2094,2041,23,resign,white,53,D24,Queen's Gambit Accepted: Showalter Variation
1641,1645,45,resign,white,4,D21,Queen's Gambit Accepted: Slav Gambit
1731,1395,69,mate,white,336,D21,Queen's Gambit Accepted: Slav Gambit
1721,1643,53,resign,white,78,D30,Queen's Gambit Declined
1398,1383,91,mate,white,15,D30,Queen's Gambit Declined
1371,1374,37,resign,white,3,D30,Queen's Gambit Declined
1152,1284,55,mate,white,132,D30,Queen's Gambit Declined
1597,1504,19,resign,white,93,D30,Queen's Gambit Declined
1473,1401,43,mate,white,72,D30,Queen's Gambit Declined
1755,1293,31,mate,white,462,D30,Queen's Gambit Declined
1732,1653,42,resign,white,79,D30,Queen's Gambit Declined
1163,1214,47,mate,white,51,D30,Queen's Gambit Declined
1826,1965,61,resign,white,139,D30,Queen's Gambit Declined
1748,996,55,mate,white,752,D30,Queen's Gambit Declined
1640,1881,53,resign,white,241,D30,Queen's Gambit Declined
1594,1608,55,resign,white,14,D30,Queen's Gambit Declined
1629,1047,49,mate,white,582,D30,Queen's Gambit Declined
1329,1279,61,mate,white,50,D30,Queen's Gambit Declined
1570,1440,114,resign,white,130,D30,Queen's Gambit Declined
1573,1604,38,resign,white,31,D30,Queen's Gambit Declined
1540,1579,57,resign,white,39,D30,Queen's Gambit Declined
1532,1538,33,resign,white,6,D30,Queen's Gambit Declined
1588,1632,63,mate,white,44,D30,Queen's Gambit Declined
1757,1728,37,resign,white,29,D30,Queen's Gambit Declined
1724,1438,95,time,white,286,D30,Queen's Gambit Declined
1662,1701,31,resign,white,39,D30,Queen's Gambit Declined
1585,1295,41,time,white,290,D30,Queen's Gambit Declined
1846,1524,43,mate,white,322,D30,Queen's Gambit Declined
1694,1755,115,mate,white,61,D30,Queen's Gambit Declined
1282,1394,77,mate,white,112,D30,Queen's Gambit Declined
1799,2073,43,resign,white,274,D53,Queen's Gambit Declined: 4.Bg5 Be7
1696,1515,87,time,white,181,D53,Queen's Gambit Declined: 4.Bg5 Be7
2105,1738,40,resign,white,367,D53,Queen's Gambit Declined: 4.Bg5 Be7
2080,2278,65,resign,white,198,D53,Queen's Gambit Declined: 4.Bg5 Be7 |  5.e3 O-O
1595,1660,79,resign,white,65,D31,Queen's Gambit Declined: Alapin Variation
1532,1773,89,resign,white,241,D50,Queen's Gambit Declined: Been-Koomen Variation
1795,1811,117,mate,white,16,D30,Queen's Gambit Declined: Capablanca
1683,1814,43,resign,white,131,D31,Queen's Gambit Declined: Charousek (Petrosian) Variation
1552,1567,41,resign,white,15,D35,Queen's Gambit Declined: Exchange Variation
2054,1636,53,mate,white,418,D35,Queen's Gambit Declined: Exchange Variation |  Positional Variation #2
1711,1760,43,resign,white,49,D35,Queen's Gambit Declined: Harrwitz Attack
1630,1697,51,resign,white,67,D35,Queen's Gambit Declined: Harrwitz Attack
1546,1523,73,resign,white,23,D35,Queen's Gambit Declined: Harrwitz Attack
1609,1526,155,resign,white,83,D50,Queen's Gambit Declined: Modern Variation
1792,1788,71,resign,white,4,D50,Queen's Gambit Declined: Modern Variation
1504,1541,41,resign,white,37,D50,Queen's Gambit Declined: Modern Variation
1683,1619,62,resign,white,64,D55,Queen's Gambit Declined: Modern Variation |  Normal Line
2258,2177,65,resign,white,81,D55,Queen's Gambit Declined: Modern Variation |  Normal Line
1719,1679,42,resign,white,40,D35,Queen's Gambit Declined: Normal Defense
1928,1213,69,resign,white,715,D35,Queen's Gambit Declined: Normal Defense
2105,1806,57,mate,white,299,D35,Queen's Gambit Declined: Normal Defense
1713,1525,55,resign,white,188,D35,Queen's Gambit Declined: Normal Defense
1848,1857,39,resign,white,9,D60,Queen's Gambit Declined: Orthodox Defense
1729,1795,111,mate,white,66,D31,Queen's Gambit Declined: Queen's Knight Variation
1889,1641,55,mate,white,248,D31,Queen's Gambit Declined: Queen's Knight Variation
1684,1785,32,resign,white,101,D31,Queen's Gambit Declined: Queen's Knight Variation
2108,1736,101,resign,white,372,D31,Queen's Gambit Declined: Queen's Knight Variation
1626,1282,97,mate,white,344,D31,Queen's Gambit Declined: Queen's Knight Variation
1172,1060,41,mate,white,112,D31,Queen's Gambit Declined: Queen's Knight Variation
1663,1284,29,resign,white,379,D31,Queen's Gambit Declined: Queen's Knight Variation
1670,1460,33,resign,white,210,D31,Queen's Gambit Declined: Queen's Knight Variation
1563,1462,53,resign,white,101,D31,Queen's Gambit Declined: Queen's Knight Variation
1379,1421,29,mate,white,42,D31,Queen's Gambit Declined: Queen's Knight Variation
1756,1765,51,resign,white,9,D30,Queen's Gambit Declined: Tarrasch Defense |  Pseudo-Tarrasch
1823,1554,35,mate,white,269,D30,Queen's Gambit Declined: Tarrasch Defense |  Pseudo-Tarrasch
2283,1947,61,mate,white,336,D37,Queen's Gambit Declined: Three Knights Variation
1693,1585,125,mate,white,108,D37,Queen's Gambit Declined: Three Knights Variation
1873,1630,22,resign,white,243,D37,Queen's Gambit Declined: Three Knights Variation
1670,1485,39,resign,white,185,D37,Queen's Gambit Declined: Three Knights Variation
1721,1750,91,resign,white,29,D30,Queen's Gambit Declined: Traditional Variation
2418,2067,39,resign,white,351,D30,Queen's Gambit Declined: Traditional Variation
1687,1717,107,time,white,30,D30,Queen's Gambit Declined: Traditional Variation
1868,1663,93,mate,white,205,D30,Queen's Gambit Declined: Traditional Variation
1883,1646,29,resign,white,237,D44,Queen's Gambit Declined: Vienna Variation |  Quiet Variation
1148,1099,41,mate,white,49,D44,Queen's Gambit Declined: Vienna Variation |  Quiet Variation
1782,1484,59,resign,white,298,D08,Queen's Gambit Refused: Albin Countergambit
1149,1119,19,resign,white,30,D08,Queen's Gambit Refused: Albin Countergambit
1685,1579,73,time,white,106,D08,Queen's Gambit Refused: Albin Countergambit
1311,1495,30,resign,white,184,D08,Queen's Gambit Refused: Albin Countergambit
1610,1606,71,mate,white,4,D08,Queen's Gambit Refused: Albin Countergambit |  Lasker Trap
1599,1609,73,resign,white,10,D08,Queen's Gambit Refused: Albin Countergambit |  Lasker Trap
1684,1720,23,resign,white,36,D08,Queen's Gambit Refused: Albin Countergambit |  Normal Line
1805,1815,45,mate,white,10,D08,Queen's Gambit Refused: Albin Countergambit |  Normal Line
1524,1499,89,mate,white,25,D06,Queen's Gambit Refused: Austrian Defense
1470,1029,59,resign,white,441,D06,Queen's Gambit Refused: Austrian Defense
1581,1545,33,resign,white,36,D06,Queen's Gambit Refused: Austrian Defense
1602,1671,45,resign,white,69,D02,Queen's Gambit Refused: Baltic Defense
1579,1022,34,resign,white,557,D02,Queen's Gambit Refused: Baltic Defense
1594,1554,39,mate,white,40,D02,Queen's Gambit Refused: Baltic Defense
1701,1470,31,resign,white,231,D02,Queen's Gambit Refused: Baltic Defense
1148,1153,61,mate,white,5,D02,Queen's Gambit Refused: Baltic Defense
1879,1671,95,resign,white,208,D02,Queen's Gambit Refused: Baltic Defense |  Pseudo-Slav
1874,2020,81,resign,white,146,D02,Queen's Gambit Refused: Baltic Defense |  Pseudo-Slav
1614,1607,69,resign,white,7,D02,Queen's Gambit Refused: Baltic Defense |  Pseudo-Slav
2185,1851,60,resign,white,334,D02,Queen's Gambit Refused: Baltic Defense |  Pseudo-Slav
1273,1016,79,mate,white,257,D07,Queen's Gambit Refused: Chigorin Defense
1887,1564,53,mate,white,323,D07,Queen's Gambit Refused: Chigorin Defense #2
2193,1963,19,resign,white,230,D07,Queen's Gambit Refused: Chigorin Defense #2
1565,1445,43,resign,white,120,D07,Queen's Gambit Refused: Chigorin Defense #2
1182,1459,57,resign,white,277,D07,Queen's Gambit Refused: Chigorin Defense #2
1581,1798,67,resign,white,217,D07,Queen's Gambit Refused: Chigorin Defense #2
1416,1330,23,resign,white,86,D07,Queen's Gambit Refused: Chigorin Defense |  Exchange Variation
1350,1285,61,mate,white,65,D07,Queen's Gambit Refused: Chigorin Defense |  Janowski Variation
1757,1825,73,mate,white,68,D06,Queen's Gambit Refused: Chigorin Defense |  Lazard Gambit
2235,2010,63,time,white,225,D07,Queen's Gambit Refused: Chigorin Defense |  Main Line
1640,1650,49,mate,white,10,D06,Queen's Gambit Refused: Chigorin Defense |  Modern Gambit
1908,1421,61,mate,white,487,D06,Queen's Gambit Refused: Chigorin Defense |  Modern Gambit
1447,1273,63,mate,white,174,D06,Queen's Gambit Refused: Chigorin Defense |  Modern Gambit
1734,1748,62,resign,white,14,D06,Queen's Gambit Refused: Marshall Defense
1227,1216,97,mate,white,11,D06,Queen's Gambit Refused: Marshall Defense
1318,1449,43,resign,white,131,D06,Queen's Gambit Refused: Marshall Defense
1840,1785,29,resign,white,55,D06,Queen's Gambit Refused: Marshall Defense
1579,1522,23,resign,white,57,D06,Queen's Gambit Refused: Marshall Defense
1903,1454,27,mate,white,449,D06,Queen's Gambit Refused: Marshall Defense
1803,1335,35,resign,white,468,D06,Queen's Gambit Refused: Marshall Defense
1421,1347,69,time,white,74,D06,Queen's Gambit Refused: Marshall Defense
1615,1332,69,resign,white,283,D06,Queen's Gambit Refused: Marshall Defense
1715,1788,109,resign,white,73,D06,Queen's Gambit Refused: Marshall Defense
1714,1658,11,resign,white,56,D06,Queen's Gambit Refused: Marshall Defense
1378,1326,89,resign,white,52,D06,Queen's Gambit Refused: Marshall Defense
1510,1171,23,resign,white,339,D06,Queen's Gambit Refused: Marshall Defense
1617,1575,105,resign,white,42,D06,Queen's Gambit Refused: Marshall Defense
1681,1571,11,resign,white,110,D06,Queen's Gambit Refused: Marshall Defense
1668,1697,53,resign,white,29,D06,Queen's Gambit Refused: Marshall Defense
1531,1543,129,mate,white,12,D06,Queen's Gambit Refused: Marshall Defense
2043,1396,17,resign,white,647,D06,Queen's Gambit Refused: Marshall Defense
1705,1674,47,time,white,31,D06,Queen's Gambit Refused: Marshall Defense
1594,1526,41,resign,white,68,D06,Queen's Gambit Refused: Marshall Defense
1712,1463,55,resign,white,249,D06,Queen's Gambit Refused: Marshall Defense
1494,1453,143,resign,white,41,D06,Queen's Gambit Refused: Marshall Defense
1631,1284,27,resign,white,347,D06,Queen's Gambit Refused: Marshall Defense
1714,1577,139,mate,white,137,D06,Queen's Gambit Refused: Marshall Defense
1583,1622,89,mate,white,39,D06,Queen's Gambit Refused: Marshall Defense
1731,1560,74,resign,white,171,D06,Queen's Gambit Refused: Marshall Defense
1301,1697,99,resign,white,396,D06,Queen's Gambit Refused: Marshall Defense
1794,1784,35,resign,white,10,D06,Queen's Gambit Refused: Marshall Defense
1699,1803,49,mate,white,104,D06,Queen's Gambit Refused: Marshall Defense
1921,1685,24,resign,white,236,D06,Queen's Gambit Refused: Marshall Defense
1860,1657,52,resign,white,203,D06,Queen's Gambit Refused: Marshall Defense
1271,1346,49,mate,white,75,D06,Queen's Gambit Refused: Marshall Defense
1729,1726,61,resign,white,3,A50,Queen's Indian Accelerated
1994,1886,77,resign,white,108,E15,Queen's Indian Defense: Fianchetto Traditional
2014,1893,37,resign,white,121,E15,Queen's Indian Defense: Fianchetto Traditional
1938,1985,69,resign,white,47,E15,Queen's Indian Defense: Fianchetto Traditional
1794,1750,38,resign,white,44,E12,Queen's Indian Defense: Kasparov Variation
1522,1512,114,resign,white,10,A40,Queen's Pawn
1847,1802,58,resign,white,45,A40,Queen's Pawn
1678,1595,103,resign,white,83,A41,Queen's Pawn
1845,1507,37,resign,white,338,A40,Queen's Pawn
1637,1205,25,resign,white,432,A40,Queen's Pawn
1123,1256,15,resign,white,133,A40,Queen's Pawn
1363,1447,37,mate,white,84,A40,Queen's Pawn
1653,1453,115,mate,white,200,A40,Queen's Pawn
1554,1479,53,resign,white,75,A40,Queen's Pawn
1334,1183,73,time,white,151,A40,Queen's Pawn
1657,1033,10,resign,white,624,A40,Queen's Pawn
1706,1208,45,mate,white,498,A40,Queen's Pawn
1817,1911,153,mate,white,94,A40,Queen's Pawn
1329,1547,3,resign,white,218,A40,Queen's Pawn
1500,1500,27,mate,white,0,A41,Queen's Pawn
1252,1387,17,resign,white,135,A40,Queen's Pawn
1848,1814,79,mate,white,34,A41,Queen's Pawn
1707,1596,53,resign,white,111,A40,Queen's Pawn
1741,1874,61,resign,white,133,A40,Queen's Pawn
1415,1493,121,resign,white,78,A40,Queen's Pawn
1635,1436,103,mate,white,199,A41,Queen's Pawn
1590,1461,51,resign,white,129,A41,Queen's Pawn
1572,1454,19,resign,white,118,A41,Queen's Pawn
1825,1769,129,mate,white,56,A41,Queen's Pawn
1937,1870,41,resign,white,67,A41,Queen's Pawn
1492,1438,49,resign,white,54,A41,Queen's Pawn
1328,1146,87,resign,white,182,A41,Queen's Pawn
1606,1101,49,resign,white,505,A40,Queen's Pawn
1707,1693,73,resign,white,14,D00,Queen's Pawn Game
1306,1429,63,mate,white,123,D00,Queen's Pawn Game
1801,1854,127,resign,white,53,D00,Queen's Pawn Game
1256,937,35,resign,white,319,D00,Queen's Pawn Game
1570,1750,9,resign,white,180,D00,Queen's Pawn Game
1433,1508,63,resign,white,75,D00,Queen's Pawn Game
1458,1478,51,resign,white,20,D00,Queen's Pawn Game
1353,1406,101,mate,white,53,D00,Queen's Pawn Game
1738,1645,51,resign,white,93,D00,Queen's Pawn Game
1544,1427,31,resign,white,117,D00,Queen's Pawn Game
1803,1723,69,time,white,80,D00,Queen's Pawn Game
1545,1393,189,resign,white,152,D00,Queen's Pawn Game
1487,1547,89,mate,white,60,D00,Queen's Pawn Game
1916,1911,75,resign,white,5,D00,Queen's Pawn Game
1545,1590,31,resign,white,45,D00,Queen's Pawn Game
1338,1277,9,resign,white,61,D00,Queen's Pawn Game #2
1241,1460,59,resign,white,219,D00,Queen's Pawn Game #2
1581,1495,39,resign,white,86,D00,Queen's Pawn Game #2
1833,1214,53,resign,white,619,D00,Queen's Pawn Game #2
1209,831,33,mate,white,378,D00,Queen's Pawn Game #2
1919,1994,85,resign,white,75,D00,Queen's Pawn Game #2
1405,1227,27,resign,white,178,D00,Queen's Pawn Game #2
1338,1322,69,resign,white,16,D00,Queen's Pawn Game #2
1336,1337,47,resign,white,1,D00,Queen's Pawn Game #2
1426,1347,79,mate,white,79,D00,Queen's Pawn Game #2
1804,1358,57,mate,white,446,D00,Queen's Pawn Game #2
1445,1576,43,resign,white,131,D00,Queen's Pawn Game #2
1559,1577,23,mate,white,18,D00,Queen's Pawn Game #2
1515,1602,27,resign,white,87,D00,Queen's Pawn Game #2
1483,1222,109,mate,white,261,D00,Queen's Pawn Game #2
1908,1414,57,resign,white,494,D00,Queen's Pawn Game #2
1362,1076,85,resign,white,286,D00,Queen's Pawn Game #2
1331,1281,53,time,white,50,D00,Queen's Pawn Game #3
1203,894,95,mate,white,309,D00,Queen's Pawn Game #3
1763,1358,53,time,white,405,D00,Queen's Pawn Game #3
1256,1286,102,resign,white,30,D00,Queen's Pawn Game #3
1284,1373,95,resign,white,89,D00,Queen's Pawn Game #3
1310,1117,95,mate,white,193,D00,Queen's Pawn Game #3
1513,1542,57,resign,white,29,D00,Queen's Pawn Game #3
1657,1384,57,mate,white,273,D00,Queen's Pawn Game #3
2069,1875,46,resign,white,194,A41,Queen's Pawn Game: Anglo-Slav Opening
2340,1857,69,mate,white,483,D02,Queen's Pawn Game: Anti-Torre
1179,1610,81,resign,white,431,D02,Queen's Pawn Game: Anti-Torre
2255,1806,67,resign,white,449,D02,Queen's Pawn Game: Barry Attack |  Gruenfeld Variation
1078,1219,69,mate,white,141,D01,Queen's Pawn Game: Chigorin Variation
1758,1702,43,resign,white,56,D02,Queen's Pawn Game: Chigorin Variation
1791,1716,55,mate,white,75,D00,Queen's Pawn Game: Chigorin Variation
1699,1457,35,mate,white,242,D02,Queen's Pawn Game: Chigorin Variation
1393,1272,51,mate,white,121,D01,Queen's Pawn Game: Chigorin Variation
964,1029,105,resign,white,65,D00,Queen's Pawn Game: Chigorin Variation
1405,1417,49,mate,white,12,D01,Queen's Pawn Game: Chigorin Variation
1397,1415,49,resign,white,18,D00,Queen's Pawn Game: Chigorin Variation
1171,1422,13,resign,white,251,D00,Queen's Pawn Game: Chigorin Variation
1110,1500,36,resign,white,390,D00,Queen's Pawn Game: Chigorin Variation
1098,1123,119,resign,white,25,D00,Queen's Pawn Game: Chigorin Variation
1709,1629,87,mate,white,80,D02,Queen's Pawn Game: Chigorin Variation
1683,1495,71,resign,white,188,D02,Queen's Pawn Game: Chigorin Variation
1245,1277,61,mate,white,32,D02,Queen's Pawn Game: Chigorin Variation
1017,1223,115,resign,white,206,D01,Queen's Pawn Game: Chigorin Variation
1111,1275,43,resign,white,164,D01,Queen's Pawn Game: Chigorin Variation
1689,1254,57,resign,white,435,D02,Queen's Pawn Game: Chigorin Variation
1269,1136,29,resign,white,133,D02,Queen's Pawn Game: Chigorin Variation
1837,1900,79,mate,white,63,D02,Queen's Pawn Game: Chigorin Variation
2031,1807,69,mate,white,224,D02,Queen's Pawn Game: Chigorin Variation
1861,1299,39,mate,white,562,D02,Queen's Pawn Game: Chigorin Variation
1502,1635,71,resign,white,133,D00,Queen's Pawn Game: Chigorin Variation
1194,1356,43,resign,white,162,D02,Queen's Pawn Game: Chigorin Variation
1429,1377,33,resign,white,52,D02,Queen's Pawn Game: Chigorin Variation
1689,1500,37,mate,white,189,D00,Queen's Pawn Game: Chigorin Variation
1328,1163,15,resign,white,165,D00,Queen's Pawn Game: Chigorin Variation
1549,1427,31,resign,white,122,D02,Queen's Pawn Game: Chigorin Variation
1321,1826,83,mate,white,505,D01,Queen's Pawn Game: Chigorin Variation
1240,1047,123,time,white,193,D00,Queen's Pawn Game: Chigorin Variation
2208,1748,57,mate,white,460,D02,Queen's Pawn Game: Chigorin Variation
1470,1538,93,time,white,68,D02,Queen's Pawn Game: Chigorin Variation
1629,1439,87,resign,white,190,D01,Queen's Pawn Game: Chigorin Variation
2003,1413,39,resign,white,590,D02,Queen's Pawn Game: Chigorin Variation
1405,1437,27,resign,white,32,D00,Queen's Pawn Game: Chigorin Variation
1625,1603,12,resign,white,22,D00,Queen's Pawn Game: Chigorin Variation
1619,1644,71,mate,white,25,D02,Queen's Pawn Game: Chigorin Variation
1638,1303,35,mate,white,335,D01,Queen's Pawn Game: Chigorin Variation
1293,1234,29,resign,white,59,D02,Queen's Pawn Game: Chigorin Variation
1250,1439,33,resign,white,189,D02,Queen's Pawn Game: Chigorin Variation
1230,1297,117,time,white,67,D02,Queen's Pawn Game: Chigorin Variation
1718,2210,43,resign,white,492,D01,Queen's Pawn Game: Chigorin Variation
1574,1562,89,time,white,12,D04,Queen's Pawn Game: Colle System
1857,1737,57,resign,white,120,D04,Queen's Pawn Game: Colle System
1939,1778,47,resign,white,161,D04,Queen's Pawn Game: Colle System
1514,1489,59,time,white,25,D04,Queen's Pawn Game: Colle System
1325,1353,21,resign,white,28,D04,Queen's Pawn Game: Colle System
1918,1699,53,mate,white,219,D04,Queen's Pawn Game: Colle System
1798,1885,65,resign,white,87,A48,Queen's Pawn Game: Colle System |  Gruenfeld Formation
1708,1528,107,mate,white,180,C00,Queen's Pawn Game: Franco-Sicilian Defense
1993,1860,85,mate,white,133,C00,Queen's Pawn Game: Franco-Sicilian Defense
1600,1432,47,mate,white,168,C00,Queen's Pawn Game: Franco-Sicilian Defense
1396,1131,57,mate,white,265,D02,Queen's Pawn Game: Krause Variation
1638,1570,101,mate,white,68,D02,Queen's Pawn Game: Krause Variation
1554,1713,56,resign,white,159,D02,Queen's Pawn Game: Krause Variation
1188,1118,21,mate,white,70,D00,Queen's Pawn Game: Levitsky Attack
1728,1769,26,resign,white,41,D00,Queen's Pawn Game: Levitsky Attack
1900,1810,21,resign,white,90,D00,Queen's Pawn Game: Levitsky Attack
1882,1828,35,resign,white,54,D00,Queen's Pawn Game: Levitsky Attack
1667,1394,62,resign,white,273,D00,Queen's Pawn Game: Levitsky Attack
1571,1728,131,resign,white,157,D02,Queen's Pawn Game: London System
1536,1667,57,mate,white,131,D02,Queen's Pawn Game: London System
1539,1418,51,resign,white,121,D02,Queen's Pawn Game: London System
1501,1445,38,resign,white,56,D02,Queen's Pawn Game: London System
1706,925,59,mate,white,781,D02,Queen's Pawn Game: London System
1586,1473,17,resign,white,113,D02,Queen's Pawn Game: London System
1863,1899,39,resign,white,36,D02,Queen's Pawn Game: London System
2218,1953,79,resign,white,265,D02,Queen's Pawn Game: London System
2226,1977,65,resign,white,249,D02,Queen's Pawn Game: London System
2199,2112,51,resign,white,87,D02,Queen's Pawn Game: London System
1681,1216,85,mate,white,465,D02,Queen's Pawn Game: London System
2002,2056,95,resign,white,54,D02,Queen's Pawn Game: London System
1988,1931,86,resign,white,57,D02,Queen's Pawn Game: London System
1509,1520,47,resign,white,11,D02,Queen's Pawn Game: London System
1544,1461,61,resign,white,83,D00,Queen's Pawn Game: Mason Attack
1552,1436,61,resign,white,116,D00,Queen's Pawn Game: Mason Attack
1537,1408,71,resign,white,129,D00,Queen's Pawn Game: Mason Attack
1576,1386,43,resign,white,190,D00,Queen's Pawn Game: Mason Attack
1591,1326,49,resign,white,265,D00,Queen's Pawn Game: Mason Attack
1470,1684,45,resign,white,214,D00,Queen's Pawn Game: Mason Attack
1148,1057,29,resign,white,91,D00,Queen's Pawn Game: Mason Attack
1477,1189,49,mate,white,288,D00,Queen's Pawn Game: Mason Attack
1398,1286,135,mate,white,112,D00,Queen's Pawn Game: Mason Attack
1416,1491,131,mate,white,75,D00,Queen's Pawn Game: Mason Attack
1405,1408,79,mate,white,3,D00,Queen's Pawn Game: Mason Attack
1125,1124,119,time,white,1,D00,Queen's Pawn Game: Mason Attack
1846,1561,17,mate,white,285,D00,Queen's Pawn Game: Mason Attack
1814,1569,79,mate,white,245,D00,Queen's Pawn Game: Mason Attack
1712,1752,63,mate,white,40,D00,Queen's Pawn Game: Mason Attack
2001,1740,153,resign,white,261,D00,Queen's Pawn Game: Mason Attack
1489,1592,16,resign,white,103,D00,Queen's Pawn Game: Mason Attack
2067,1843,82,resign,white,224,D00,Queen's Pawn Game: Mason Attack
1641,1643,171,resign,white,2,D00,Queen's Pawn Game: Mason Attack
1629,1699,65,mate,white,70,D00,Queen's Pawn Game: Mason Attack
1492,1487,53,mate,white,5,D00,Queen's Pawn Game: Mason Attack
1514,1378,16,resign,white,136,D00,Queen's Pawn Game: Mason Attack
1172,996,71,mate,white,176,D00,Queen's Pawn Game: Mason Attack
1314,1099,11,resign,white,215,D00,Queen's Pawn Game: Mason Attack
1228,1133,141,mate,white,95,D00,Queen's Pawn Game: Mason Attack
1309,1347,50,resign,white,38,D00,Queen's Pawn Game: Mason Attack
2098,1897,89,resign,white,201,D00,Queen's Pawn Game: Mason Attack
1838,1798,77,mate,white,40,D00,Queen's Pawn Game: Mason Attack
1793,1768,45,resign,white,25,D00,Queen's Pawn Game: Mason Attack
1904,1862,131,mate,white,42,D00,Queen's Pawn Game: Mason Attack
1206,1368,15,resign,white,162,D00,Queen's Pawn Game: Mason Attack
1471,1412,83,mate,white,59,D00,Queen's Pawn Game: Mason Attack
1956,1715,77,resign,white,241,D00,Queen's Pawn Game: Mason Attack
1520,1468,107,time,white,52,D00,Queen's Pawn Game: Mason Attack
1306,1409,31,mate,white,103,D00,Queen's Pawn Game: Mason Attack
2104,1818,165,mate,white,286,D00,Queen's Pawn Game: Mason Attack
1485,1474,73,resign,white,11,D00,Queen's Pawn Game: Mason Attack
1482,1483,49,mate,white,1,D00,Queen's Pawn Game: Mason Attack
1468,1592,52,resign,white,124,D00,Queen's Pawn Game: Mason Attack
1457,1446,79,mate,white,11,D00,Queen's Pawn Game: Mason Attack
1363,1299,21,resign,white,64,D00,Queen's Pawn Game: Mason Attack
1542,1399,28,resign,white,143,D00,Queen's Pawn Game: Steinitz Countergambit
2035,1818,23,resign,white,217,D00,Queen's Pawn Game: Steinitz Countergambit
2118,1294,25,resign,white,824,D02,Queen's Pawn Game: Symmetrical Variation
1596,1360,111,resign,white,236,D02,Queen's Pawn Game: Symmetrical Variation
1525,1367,45,resign,white,158,D02,Queen's Pawn Game: Symmetrical Variation
2312,2277,151,time,white,35,D02,Queen's Pawn Game: Symmetrical Variation
1814,1661,33,resign,white,153,D02,Queen's Pawn Game: Symmetrical Variation
1604,1344,55,mate,white,260,D02,Queen's Pawn Game: Symmetrical Variation |  Pseudo-Catalan
1430,1302,63,resign,white,128,D03,Queen's Pawn Game: Torre Attack
1712,1770,105,resign,white,58,D03,Queen's Pawn Game: Torre Attack
2330,2234,61,mate,white,96,D03,Queen's Pawn Game: Torre Attack |  Gruenfeld Variation |  Main Line
1202,1375,65,mate,white,173,D01,Queen's Pawn Game: Veresov Attack |  Classical Defense
1484,1743,51,resign,white,259,D01,Queen's Pawn Game: Veresov Attack |  Classical Defense
1439,1454,61,mate,white,15,D02,Queen's Pawn Game: Zukertort Variation
1770,1872,33,resign,white,102,D02,Queen's Pawn Game: Zukertort Variation
1020,1200,65,time,white,180,D02,Queen's Pawn Game: Zukertort Variation
1525,1693,60,resign,white,168,D02,Queen's Pawn Game: Zukertort Variation
1322,913,65,mate,white,409,D02,Queen's Pawn Game: Zukertort Variation
1348,1381,43,resign,white,33,D02,Queen's Pawn Game: Zukertort Variation
1500,1545,75,mate,white,45,D02,Queen's Pawn Game: Zukertort Variation
1278,1463,117,mate,white,185,D02,Queen's Pawn Game: Zukertort Variation
1649,1672,105,resign,white,23,D02,Queen's Pawn Game: Zukertort Variation
2231,1882,73,resign,white,349,D02,Queen's Pawn Game: Zukertort Variation
1375,1332,3,time,white,43,D02,Queen's Pawn Game: Zukertort Variation
1555,1575,61,mate,white,20,D02,Queen's Pawn Game: Zukertort Variation
1045,1101,95,resign,white,56,D02,Queen's Pawn Game: Zukertort Variation
1231,905,9,resign,white,326,D02,Queen's Pawn Game: Zukertort Variation
1874,1863,107,time,white,11,D02,Queen's Pawn Game: Zukertort Variation
1713,1848,37,resign,white,135,D02,Queen's Pawn Game: Zukertort Variation
1640,1644,93,resign,white,4,D02,Queen's Pawn Game: Zukertort Variation
1997,1778,51,mate,white,219,D02,Queen's Pawn Game: Zukertort Variation
2010,2036,100,resign,white,26,D02,Queen's Pawn Game: Zukertort Variation
2035,1492,29,mate,white,543,D02,Queen's Pawn Game: Zukertort Variation
1449,1337,44,resign,white,112,D02,Queen's Pawn Game: Zukertort Variation
1639,1504,3,resign,white,135,D02,Queen's Pawn Game: Zukertort Variation
1687,1218,39,mate,white,469,D00,Queen's Pawn Game: Zurich Gambit
1500,1516,15,resign,white,16,D00,Queen's Pawn Opening: Veresov |  Richter Attack
1463,1476,21,resign,white,13,D00,Queen's Pawn Opening: Veresov |  Richter Attack
1820,2095,27,resign,white,275,B07,Rat Defense: Accelerated Gurgenidze
1785,2116,79,resign,white,331,B07,Rat Defense: Accelerated Gurgenidze
1563,1431,74,resign,white,132,B07,Rat Defense: Accelerated Gurgenidze
2167,1933,101,resign,white,234,B07,Rat Defense: Antal Defense
1832,1696,49,resign,white,136,B07,Rat Defense: Balogh Defense
1366,1171,83,mate,white,195,A41,Rat Defense: English Rat
2141,1414,47,mate,white,727,B07,Rat Defense: Harmonist
1948,1508,57,resign,white,440,B07,Rat Defense: Harmonist
1907,1095,15,resign,white,812,C00,Rat Defense: Small Center Defense
1552,1754,25,resign,white,202,C00,Rat Defense: Small Center Defense
2274,1350,39,mate,white,924,C00,Rat Defense: Small Center Defense
1896,1910,51,mate,white,14,C00,Rat Defense: Small Center Defense
1461,1434,39,resign,white,27,C00,Rat Defense: Small Center Defense
1887,1785,55,mate,white,102,C00,Rat Defense: Small Center Defense
1966,1797,131,mate,white,169,C00,Rat Defense: Small Center Defense
1800,1842,31,mate,white,42,C00,Rat Defense: Small Center Defense
1926,1823,31,resign,white,103,C00,Rat Defense: Small Center Defense
1735,1749,85,mate,white,14,C00,Rat Defense: Small Center Defense
1927,1565,53,resign,white,362,C00,Rat Defense: Small Center Defense
1997,1631,35,resign,white,366,C00,Rat Defense: Small Center Defense
2092,1863,31,mate,white,229,C00,Rat Defense: Small Center Defense
2103,1822,57,resign,white,281,C00,Rat Defense: Small Center Defense
1704,1510,123,mate,white,194,A06,Reti Opening
1695,1643,89,time,white,52,A06,Reti Opening
1872,1895,59,resign,white,23,A06,Reti Opening
1500,1292,115,mate,white,208,A06,Reti Opening
1916,1887,75,resign,white,29,A09,Reti Opening
1330,1590,51,resign,white,260,A06,Reti Opening
1434,1505,117,mate,white,71,A06,Reti Opening
2024,1933,99,time,white,91,A04,Reti Opening #2
2247,2323,47,resign,white,76,A04,Reti Opening #2
1500,1568,85,resign,white,68,A09,Reti Opening: Reti Accepted
1781,1441,14,resign,white,340,A09,Reti Opening: Reti Accepted
1347,1331,23,mate,white,16,A09,Reti Opening: Reti Accepted
2260,2005,43,time,white,255,A09,Reti Opening: Reti Accepted
1752,1543,32,resign,white,209,D01,Richter-Veresov Attack
2046,2057,53,resign,white,11,D01,Richter-Veresov Attack #2
1318,1395,77,mate,white,77,B06,Robatsch (Modern) Defense
1425,1164,85,resign,white,261,B06,Robatsch (Modern) Defense
1971,1965,89,mate,white,6,B06,Robatsch (Modern) Defense
1431,1235,61,resign,white,196,B06,Robatsch (Modern) Defense
1434,1195,25,resign,white,239,B06,Robatsch (Modern) Defense
1498,1531,39,resign,white,33,B06,Robatsch (Modern) Defense
1412,1344,89,mate,white,68,B06,Robatsch (Modern) Defense
2323,1881,41,resign,white,442,C42,Russian Game: Classical Attack |  Staunton Variation
2199,1955,15,resign,white,244,C42,Russian Game: Cochrane Gambit
1522,1364,22,resign,white,158,C42,Russian Game: Cozio (Lasker) Attack
1950,1620,103,resign,white,330,C42,Russian Game: Cozio (Lasker) Attack
1369,1368,87,mate,white,1,C42,Russian Game: Damiano Variation
1522,1500,11,mate,white,22,C42,Russian Game: Damiano Variation
1216,1041,11,mate,white,175,C42,Russian Game: Damiano Variation
1310,1304,9,mate,white,6,C42,Russian Game: Damiano Variation
1356,1186,15,resign,white,170,C42,Russian Game: Damiano Variation
1500,1081,43,mate,white,419,C42,Russian Game: Damiano Variation
1546,1464,45,mate,white,82,C42,Russian Game: Damiano Variation
1388,1112,64,resign,white,276,C42,Russian Game: Damiano Variation
1240,1219,55,mate,white,21,C42,Russian Game: Damiano Variation |  Kholmov Gambit
1293,1048,11,resign,white,245,C42,Russian Game: Damiano Variation |  Kholmov Gambit
2121,2118,61,resign,white,3,C42,Russian Game: Karklins-Martinovsky Variation
2130,2054,71,resign,white,76,C43,Russian Game: Modern Attack |  Center Variation
1172,1170,15,resign,white,2,C42,Russian Game: Three Knights Game
1171,1252,19,resign,white,81,C42,Russian Game: Three Knights Game
1125,996,93,mate,white,129,C42,Russian Game: Three Knights Game
1960,1950,61,resign,white,10,C42,Russian Game: Three Knights Game
1286,1083,29,time,white,203,C42,Russian Game: Three Knights Game
1282,1018,33,mate,white,264,C42,Russian Game: Three Knights Game
1310,1273,89,resign,white,37,C42,Russian Game: Three Knights Game
1282,1234,38,resign,white,48,C42,Russian Game: Three Knights Game
1175,1121,67,mate,white,54,C42,Russian Game: Three Knights Game
1221,1166,39,mate,white,55,C42,Russian Game: Three Knights Game
1110,1104,53,mate,white,6,C42,Russian Game: Three Knights Game
1780,1157,24,resign,white,623,C42,Russian Game: Three Knights Game
1379,1149,21,resign,white,230,C42,Russian Game: Three Knights Game
1162,1132,58,resign,white,30,C42,Russian Game: Three Knights Game
1576,1548,41,mate,white,28,C42,Russian Game: Three Knights Game
1143,1097,13,resign,white,46,C42,Russian Game: Three Knights Game
1933,1499,46,resign,white,434,C42,Russian Game: Three Knights Game
1130,1044,35,resign,white,86,C42,Russian Game: Three Knights Game
1537,1460,65,mate,white,77,C42,Russian Game: Three Knights Game
1352,1352,33,mate,white,0,C42,Russian Game: Three Knights Game
1933,2008,53,resign,white,75,C42,Russian Game: Three Knights Game
998,835,31,mate,white,163,C42,Russian Game: Urusov Gambit
1134,1259,29,resign,white,125,C42,Russian Game: Urusov Gambit
1550,1466,67,resign,white,84,C42,Russian Game: Urusov Gambit
1544,1444,123,resign,white,100,C42,Russian Game: Urusov Gambit
1820,1792,33,resign,white,28,C42,Russian Game: Urusov Gambit
1311,1338,80,resign,white,27,C42,Russian Game: Urusov Gambit
1635,1432,74,resign,white,203,C42,Russian Game: Urusov Gambit
1337,1297,19,mate,white,40,C42,Russian Game: Urusov Gambit
1478,1129,85,mate,white,349,C42,Russian Game: Urusov Gambit
1662,1265,69,mate,white,397,C42,Russian Game: Urusov Gambit
1241,1200,44,resign,white,41,C42,Russian Game: Urusov Gambit
1377,1255,61,mate,white,122,C42,Russian Game: Urusov Gambit
1310,1267,21,mate,white,43,C42,Russian Game: Urusov Gambit
1640,1664,27,resign,white,24,C42,Russian Game: Urusov Gambit
1511,1514,11,time,white,3,C42,Russian Game: Urusov Gambit
1581,1631,9,resign,white,50,C42,Russian Game: Urusov Gambit
1387,1447,81,mate,white,60,C60,Ruy Lopez
1569,1349,75,mate,white,220,C60,Ruy Lopez
1467,1454,37,mate,white,13,C60,Ruy Lopez
1155,1510,65,mate,white,355,C60,Ruy Lopez
1532,1614,83,mate,white,82,C60,Ruy Lopez
1856,1517,71,resign,white,339,C60,Ruy Lopez
1414,1182,53,resign,white,232,C60,Ruy Lopez: Alapin Defense
1393,1337,77,mate,white,56,C65,Ruy Lopez: Berlin Defense
1566,1494,113,mate,white,72,C65,Ruy Lopez: Berlin Defense
1895,1750,14,resign,white,145,C65,Ruy Lopez: Berlin Defense
2032,1585,41,mate,white,447,C65,Ruy Lopez: Berlin Defense
1853,1774,65,time,white,79,C65,Ruy Lopez: Berlin Defense #2
1500,1603,59,mate,white,103,C65,Ruy Lopez: Berlin Defense #2
1257,1141,33,mate,white,116,C65,Ruy Lopez: Berlin Defense #2
1376,1351,43,mate,white,25,C65,Ruy Lopez: Berlin Defense #2
1100,1116,19,resign,white,16,C65,Ruy Lopez: Berlin Defense #2
1428,1318,31,mate,white,110,C65,Ruy Lopez: Berlin Defense #2
1609,1754,79,resign,white,145,C65,Ruy Lopez: Berlin Defense #2
1635,1583,23,resign,white,52,C65,Ruy Lopez: Berlin Defense #2
1908,1498,101,mate,white,410,C65,Ruy Lopez: Berlin Defense #2
2292,1794,19,resign,white,498,C65,Ruy Lopez: Berlin Defense #2
1451,1477,47,resign,white,26,C65,Ruy Lopez: Berlin Defense #2
2095,2029,115,resign,white,66,C65,Ruy Lopez: Berlin Defense #2
2094,2163,25,resign,white,69,C65,Ruy Lopez: Berlin Defense #2
1417,1435,17,mate,white,18,C65,Ruy Lopez: Berlin Defense #2
1854,1523,101,mate,white,331,C65,Ruy Lopez: Berlin Defense #2
1458,1373,111,resign,white,85,C65,Ruy Lopez: Berlin Defense #2
1744,1163,26,resign,white,581,C65,Ruy Lopez: Berlin Defense #2
1546,1357,103,resign,white,189,C65,Ruy Lopez: Berlin Defense #2
1147,1520,25,resign,white,373,C66,Ruy Lopez: Berlin Defense |  Closed Bernstein Variation
1500,1906,27,mate,white,406,C65,Ruy Lopez: Berlin Defense |  Fishing Pole Variation
1231,1545,37,resign,white,314,C66,Ruy Lopez: Berlin Defense |  Improved Steinitz Defense
2200,1810,43,resign,white,390,C66,Ruy Lopez: Berlin Defense |  Improved Steinitz Defense
1890,1617,73,resign,white,273,C66,Ruy Lopez: Berlin Defense |  Improved Steinitz Defense
1716,1856,73,resign,white,140,C66,Ruy Lopez: Berlin Defense |  Improved Steinitz Defense
1398,1416,63,resign,white,18,C66,Ruy Lopez: Berlin Defense |  Improved Steinitz Defense
1642,1541,49,resign,white,101,C66,Ruy Lopez: Berlin Defense |  Improved Steinitz Defense
2086,1350,33,resign,white,736,C67,Ruy Lopez: Berlin Defense |  Minckwitz Variation
1851,1853,52,resign,white,2,C67,Ruy Lopez: Berlin Defense |  Rio Gambit Accepted
2291,2144,41,resign,white,147,C67,Ruy Lopez: Berlin Defense |  Rio de Janeiro Variation
2203,2346,117,resign,white,143,C67,Ruy Lopez: Berlin Defense |  l'Hermet Variation
2118,2197,171,mate,white,79,C67,Ruy Lopez: Berlin Defense |  l'Hermet Variation
1370,1257,23,time,white,113,C61,Ruy Lopez: Bird Variation
2334,1836,49,resign,white,498,C61,Ruy Lopez: Bird Variation
1893,1624,23,resign,white,269,C61,Ruy Lopez: Bird Variation
1462,1320,43,mate,white,142,C61,Ruy Lopez: Bird Variation
1931,1915,53,resign,white,16,C61,Ruy Lopez: Bird Variation
1324,1284,43,mate,white,40,C61,Ruy Lopez: Bird Variation
999,1375,71,mate,white,376,C61,Ruy Lopez: Bird Variation
1402,1191,11,mate,white,211,C61,Ruy Lopez: Bird Variation
1407,1222,47,resign,white,185,C61,Ruy Lopez: Bird Variation
1798,1250,23,resign,white,548,C79,Ruy Lopez: Central Countergambit
1684,1700,43,mate,white,16,C64,Ruy Lopez: Classical Variation
1222,1356,29,time,white,134,C64,Ruy Lopez: Classical Variation
1844,1809,85,resign,white,35,C64,Ruy Lopez: Classical Variation |  Central Variation
1513,1601,161,mate,white,88,C64,Ruy Lopez: Classical Variation |  Central Variation
1473,1221,75,mate,white,252,C84,Ruy Lopez: Closed Variations
1473,1221,75,mate,white,252,C84,Ruy Lopez: Closed Variations
2215,1961,113,resign,white,254,C91,Ruy Lopez: Closed Variations |  Bogoljubov Variation
2121,1693,49,resign,white,428,C78,Ruy Lopez: Closed Variations |  Martinez Variation
1264,1327,97,time,white,63,C78,Ruy Lopez: Closed Variations |  Morphy Attack
1427,1213,75,mate,white,214,C68,Ruy Lopez: Columbus Variation
1106,1273,35,mate,white,167,C60,Ruy Lopez: Cozio Defense
1386,1397,75,mate,white,11,C60,Ruy Lopez: Cozio Defense
1500,1299,59,mate,white,201,C68,Ruy Lopez: Exchange Variation
1232,1234,113,mate,white,2,C68,Ruy Lopez: Exchange Variation
1460,1483,17,resign,white,23,C68,Ruy Lopez: Exchange Variation
1533,1532,35,resign,white,1,C68,Ruy Lopez: Exchange Variation
1271,1096,49,mate,white,175,C68,Ruy Lopez: Exchange Variation
1466,1303,33,resign,white,163,C68,Ruy Lopez: Exchange Variation
1746,1523,99,mate,white,223,C68,Ruy Lopez: Exchange Variation
1922,1629,59,resign,white,293,C68,Ruy Lopez: Exchange Variation
2040,1969,29,resign,white,71,C69,Ruy Lopez: Exchange Variation |  Bronstein Variation
1941,1626,24,resign,white,315,C69,Ruy Lopez: Exchange Variation |  Gligoric Variation
1524,1160,31,resign,white,364,C68,Ruy Lopez: Exchange Variation |  Keres Variation
1056,1165,83,mate,white,109,C68,Ruy Lopez: Exchange Variation |  Keres Variation
1385,1637,51,resign,white,252,C68,Ruy Lopez: Exchange Variation |  King's Bishop Variation
1783,1249,29,mate,white,534,C68,Ruy Lopez: Exchange Variation |  Lutikov Variation
1570,1565,77,resign,white,5,C68,Ruy Lopez: Exchange Variation |  Lutikov Variation
1644,1638,23,resign,white,6,C68,Ruy Lopez: Exchange Variation |  Lutikov Variation
1711,1713,65,resign,white,2,C68,Ruy Lopez: Exchange Variation |  Lutikov Variation
1251,1119,45,mate,white,132,C68,Ruy Lopez: Exchange Variation |  Lutikov Variation
1439,1341,53,resign,white,98,C68,Ruy Lopez: Exchange Variation |  Lutikov Variation
1409,1289,69,mate,white,120,C68,Ruy Lopez: Exchange Variation |  Lutikov Variation
1073,1242,57,resign,white,169,C68,Ruy Lopez: Exchange Variation |  Lutikov Variation
1500,1589,52,resign,white,89,C68,Ruy Lopez: Exchange Variation |  Lutikov Variation
1627,1148,103,mate,white,479,C69,Ruy Lopez: Exchange Variation |  Normal Variation
1596,1573,34,resign,white,23,C78,Ruy Lopez: Morphy Defense
1900,1647,59,resign,white,253,C78,Ruy Lopez: Morphy Defense
1856,1829,117,mate,white,27,C78,Ruy Lopez: Morphy Defense #2
1664,1649,34,resign,white,15,C78,Ruy Lopez: Morphy Defense #2
1775,1558,109,mate,white,217,C77,Ruy Lopez: Morphy Defense |  Anderssen Variation
1864,1833,24,resign,white,31,C77,Ruy Lopez: Morphy Defense |  Anderssen Variation
2290,2205,75,resign,white,85,C77,Ruy Lopez: Morphy Defense |  Anderssen Variation
1628,1560,99,mate,white,68,C77,Ruy Lopez: Morphy Defense |  Anderssen Variation
2291,1576,35,mate,white,715,C77,Ruy Lopez: Morphy Defense |  Anderssen Variation
2242,1967,73,resign,white,275,C77,Ruy Lopez: Morphy Defense |  Anderssen Variation
1409,1297,73,mate,white,112,C70,Ruy Lopez: Morphy Defense |  Caro Variation
1442,1183,25,resign,white,259,C70,Ruy Lopez: Morphy Defense |  Caro Variation
1531,1579,27,resign,white,48,C70,Ruy Lopez: Morphy Defense |  Caro Variation
1427,1359,44,resign,white,68,C70,Ruy Lopez: Morphy Defense |  Caro Variation
1730,1290,23,resign,white,440,C70,Ruy Lopez: Morphy Defense |  Caro Variation
1422,1635,95,time,white,213,C70,Ruy Lopez: Morphy Defense |  Caro Variation
1701,1621,139,mate,white,80,C70,Ruy Lopez: Morphy Defense |  Caro Variation
1589,1569,23,resign,white,20,C70,Ruy Lopez: Morphy Defense |  Caro Variation
1847,1895,63,resign,white,48,C70,Ruy Lopez: Morphy Defense |  Classical Defense Deferred
1845,1846,44,resign,white,1,C70,Ruy Lopez: Morphy Defense |  Classical Defense Deferred
1863,1349,35,resign,white,514,C70,Ruy Lopez: Morphy Defense |  Classical Defense Deferred
1439,1171,79,time,white,268,C70,Ruy Lopez: Morphy Defense |  Graz Variation
1164,1293,51,mate,white,129,C70,Ruy Lopez: Morphy Defense |  Graz Variation
1883,1373,39,resign,white,510,C70,Ruy Lopez: Morphy Defense |  Graz Variation
1242,953,33,mate,white,289,C70,Ruy Lopez: Morphy Defense |  Graz Variation
1290,1371,11,resign,white,81,C77,Ruy Lopez: Morphy Defense |  Mackenzie Variation
1260,1233,23,mate,white,27,C72,Ruy Lopez: Morphy Defense |  Modern Steinitz Defense
1667,1634,21,resign,white,33,C72,Ruy Lopez: Morphy Defense |  Modern Steinitz Defense
1175,1329,51,resign,white,154,C78,Ruy Lopez: Morphy Defense |  Neo-Arkhangelsk Variation
1433,1553,47,mate,white,120,C78,Ruy Lopez: Morphy Defense |  Neo-Arkhangelsk Variation
1705,1655,143,mate,white,50,C78,Ruy Lopez: Morphy Defense |  Neo-Arkhangelsk Variation
1278,1204,77,time,white,74,C70,Ruy Lopez: Morphy Defense |  Norwegian Variation
1565,1673,100,resign,white,108,C79,Ruy Lopez: Morphy Defense |  Steinitz Deferred
1704,1731,43,resign,white,27,C79,Ruy Lopez: Morphy Defense |  Steinitz Deferred
1633,1550,33,resign,white,83,C79,Ruy Lopez: Morphy Defense |  Steinitz Deferred
1617,2024,53,resign,white,407,C77,Ruy Lopez: Morphy Defense |  Tarrasch Variation
1491,1537,53,mate,white,46,C77,Ruy Lopez: Morphy Defense |  Tarrasch Variation
1786,1665,58,resign,white,121,C77,Ruy Lopez: Morphy Defense |  Tarrasch Variation
1694,1838,29,resign,white,144,C71,Ruy Lopez: Noah's Ark Trap
2415,2331,39,resign,white,84,C80,Ruy Lopez: Open Variations |  Riga Variation
1433,1306,21,resign,white,127,C80,Ruy Lopez: Open |  6.d4
2209,2102,45,resign,white,107,C63,Ruy Lopez: Schliemann Defense
1510,1412,57,mate,white,98,C63,Ruy Lopez: Schliemann Defense
1671,1594,35,resign,white,77,C60,Ruy Lopez: Schliemann Defense |  Jaenisch Gambit Accepted
1521,1403,38,resign,white,118,C60,Ruy Lopez: Schliemann Defense |  Jaenisch Gambit Accepted
1388,1356,81,mate,white,32,C60,Ruy Lopez: Spanish Countergambit
2312,1663,41,mate,white,649,C62,Ruy Lopez: Steinitz Defense
1566,1493,41,resign,white,73,C62,Ruy Lopez: Steinitz Defense
1882,1602,45,mate,white,280,C62,Ruy Lopez: Steinitz Defense
1870,1479,21,resign,white,391,C62,Ruy Lopez: Steinitz Defense
1985,1009,33,resign,white,976,C62,Ruy Lopez: Steinitz Defense
1873,1833,143,time,white,40,C62,Ruy Lopez: Steinitz Defense
1839,1819,79,resign,white,20,C62,Ruy Lopez: Steinitz Defense
1444,1476,97,resign,white,32,C62,Ruy Lopez: Steinitz Defense
1684,1511,143,resign,white,173,C62,Ruy Lopez: Steinitz Defense
1721,1621,117,resign,white,100,C62,Ruy Lopez: Steinitz Defense
1567,1494,51,mate,white,73,C62,Ruy Lopez: Steinitz Defense
1477,1541,15,resign,white,64,C62,Ruy Lopez: Steinitz Defense
1298,1398,83,mate,white,100,C62,Ruy Lopez: Steinitz Defense
1423,1418,133,resign,white,5,C62,Ruy Lopez: Steinitz Defense
1197,1176,25,mate,white,21,C62,Ruy Lopez: Steinitz Defense
1737,1745,85,time,white,8,C62,Ruy Lopez: Steinitz Defense
1888,1744,53,time,white,144,C62,Ruy Lopez: Steinitz Defense
1850,1904,41,resign,white,54,C62,Ruy Lopez: Steinitz Defense
1826,1772,119,mate,white,54,C62,Ruy Lopez: Steinitz Defense
1582,1199,35,resign,white,383,C62,Ruy Lopez: Steinitz Defense
1719,1758,173,mate,white,39,C62,Ruy Lopez: Steinitz Defense
1463,1341,75,mate,white,122,C62,Ruy Lopez: Steinitz Defense
1373,1445,29,resign,white,72,C62,Ruy Lopez: Steinitz Defense
1516,1508,71,mate,white,8,C62,Ruy Lopez: Steinitz Defense
1225,1378,71,resign,white,153,C62,Ruy Lopez: Steinitz Defense
2074,2013,75,resign,white,61,C62,Ruy Lopez: Steinitz Defense
1903,1648,37,resign,white,255,C60,Ruy Lopez: Vinogradov Variation
1803,1574,77,mate,white,229,C60,Ruy Lopez: Vinogradov Variation
1603,1559,71,resign,white,44,A00,Saragossa Opening
1433,1421,61,resign,white,12,A00,Saragossa Opening
1452,1378,79,resign,white,74,A00,Saragossa Opening
1412,1477,61,time,white,65,A00,Saragossa Opening
1383,1323,47,resign,white,60,A00,Saragossa Opening
1474,1460,54,resign,white,14,A00,Saragossa Opening
1497,1364,46,resign,white,133,A00,Saragossa Opening
1882,1806,41,resign,white,76,A00,Saragossa Opening
2204,1740,65,resign,white,464,A00,Saragossa Opening
1099,1132,93,resign,white,33,A00,Saragossa Opening
2315,2128,69,resign,white,187,A00,Saragossa Opening
2309,2091,77,resign,white,218,A00,Saragossa Opening
2273,2138,131,mate,white,135,A00,Saragossa Opening
2267,2022,63,mate,white,245,A00,Saragossa Opening
2258,2123,47,resign,white,135,A00,Saragossa Opening
1458,1509,68,resign,white,51,A00,Saragossa Opening
1295,1304,57,time,white,9,A00,Saragossa Opening
1262,1374,157,mate,white,112,A00,Saragossa Opening
1379,1418,47,mate,white,39,A00,Saragossa Opening
1478,859,39,mate,white,619,B01,Scandinavian Defense
1186,871,27,mate,white,315,B01,Scandinavian Defense
1271,883,68,resign,white,388,B01,Scandinavian Defense
1277,1241,41,mate,white,36,B01,Scandinavian Defense
966,937,105,mate,white,29,B01,Scandinavian Defense
1082,1070,33,resign,white,12,B01,Scandinavian Defense
1070,1069,30,resign,white,1,B01,Scandinavian Defense
1550,1321,67,mate,white,229,B01,Scandinavian Defense
1145,1040,54,resign,white,105,B01,Scandinavian Defense
1283,1422,53,resign,white,139,B01,Scandinavian Defense
1335,1444,55,resign,white,109,B01,Scandinavian Defense
1250,1156,75,resign,white,94,B01,Scandinavian Defense
1131,1167,52,resign,white,36,B01,Scandinavian Defense
1107,1225,16,resign,white,118,B01,Scandinavian Defense
1725,1402,39,mate,white,323,B01,Scandinavian Defense
1156,997,101,mate,white,159,B01,Scandinavian Defense
1297,1532,81,time,white,235,B01,Scandinavian Defense
1500,1524,25,mate,white,24,B01,Scandinavian Defense
989,1610,3,resign,white,621,B01,Scandinavian Defense
1125,1153,21,resign,white,28,B01,Scandinavian Defense
1112,1283,2,resign,white,171,B01,Scandinavian Defense
1080,1177,35,mate,white,97,B01,Scandinavian Defense
1257,1042,21,resign,white,215,B01,Scandinavian Defense
1127,1193,63,mate,white,66,B01,Scandinavian Defense
1288,1254,45,resign,white,34,B01,Scandinavian Defense
1754,1500,33,mate,white,254,B01,Scandinavian Defense
1390,1286,87,mate,white,104,B01,Scandinavian Defense
1359,1177,93,resign,white,182,B01,Scandinavian Defense
1014,1287,41,resign,white,273,B01,Scandinavian Defense
1734,1383,63,time,white,351,B01,Scandinavian Defense
1230,1563,39,resign,white,333,B01,Scandinavian Defense
1301,1204,159,mate,white,97,B01,Scandinavian Defense
1500,1594,41,resign,white,94,B01,Scandinavian Defense
1500,1022,69,mate,white,478,B01,Scandinavian Defense
1498,1509,11,resign,white,11,B01,Scandinavian Defense
1459,1547,61,time,white,88,B01,Scandinavian Defense
1633,1524,71,time,white,109,B01,Scandinavian Defense
1456,1467,31,resign,white,11,B01,Scandinavian Defense
1813,1999,65,time,white,186,B01,Scandinavian Defense
1437,1060,51,resign,white,377,B01,Scandinavian Defense
1362,1265,3,time,white,97,B01,Scandinavian Defense
1580,1283,41,resign,white,297,B01,Scandinavian Defense: Anderssen Counterattack
1371,1398,26,resign,white,27,B01,Scandinavian Defense: Blackburne Gambit
1472,1436,54,resign,white,36,B01,Scandinavian Defense: Blackburne Gambit
1936,1938,145,mate,white,2,B01,Scandinavian Defense: Classical Variation
1038,1074,19,resign,white,36,B01,Scandinavian Defense: Gubinsky-Melts Defense
2126,2202,51,resign,white,76,B01,Scandinavian Defense: Gubinsky-Melts Defense
1378,1430,43,mate,white,52,B01,Scandinavian Defense: Gubinsky-Melts Defense
1816,2041,133,resign,white,225,B01,Scandinavian Defense: Icelandic-Palme Gambit
1253,1472,29,resign,white,219,B01,Scandinavian Defense: Main Line
1572,1590,93,mate,white,18,B01,Scandinavian Defense: Main Line
1598,1539,121,mate,white,59,B01,Scandinavian Defense: Main Line
1745,1853,79,resign,white,108,B01,Scandinavian Defense: Main Line
1645,1411,89,resign,white,234,B01,Scandinavian Defense: Main Line
1725,1480,15,resign,white,245,B01,Scandinavian Defense: Main Line
1714,1489,51,resign,white,225,B01,Scandinavian Defense: Main Line
1495,1509,45,resign,white,14,B01,Scandinavian Defense: Main Line
1441,1533,47,mate,white,92,B01,Scandinavian Defense: Main Line
1293,1317,107,mate,white,24,B01,Scandinavian Defense: Main Line
1675,1624,59,resign,white,51,B01,Scandinavian Defense: Main Line
1806,1667,79,mate,white,139,B01,Scandinavian Defense: Main Line
1646,1640,41,resign,white,6,B01,Scandinavian Defense: Main Line
1949,2225,89,mate,white,276,B01,Scandinavian Defense: Main Line
2090,2236,81,resign,white,146,B01,Scandinavian Defense: Main Line
1519,1650,69,mate,white,131,B01,Scandinavian Defense: Main Line
1494,1348,65,mate,white,146,B01,Scandinavian Defense: Main Line
2125,2115,83,time,white,10,B01,Scandinavian Defense: Main Line |  Leonhardt Gambit
1574,861,29,resign,white,713,B01,Scandinavian Defense: Main Line |  Mieses Variation
1381,1209,119,mate,white,172,B01,Scandinavian Defense: Mieses-Kotroc Variation
1377,1249,91,resign,white,128,B01,Scandinavian Defense: Mieses-Kotroc Variation
1515,1379,87,mate,white,136,B01,Scandinavian Defense: Mieses-Kotroc Variation
1223,1282,31,mate,white,59,B01,Scandinavian Defense: Mieses-Kotroc Variation
2091,1704,27,resign,white,387,B01,Scandinavian Defense: Mieses-Kotroc Variation
1800,1831,59,mate,white,31,B01,Scandinavian Defense: Mieses-Kotroc Variation
1864,1449,27,resign,white,415,B01,Scandinavian Defense: Mieses-Kotroc Variation
1534,1467,123,mate,white,67,B01,Scandinavian Defense: Mieses-Kotroc Variation
1663,1758,33,time,white,95,B01,Scandinavian Defense: Mieses-Kotroc Variation
1873,1651,47,resign,white,222,B01,Scandinavian Defense: Mieses-Kotroc Variation
1267,1370,39,resign,white,103,B01,Scandinavian Defense: Mieses-Kotroc Variation
1095,986,11,resign,white,109,B01,Scandinavian Defense: Mieses-Kotroc Variation
912,1024,13,resign,white,112,B01,Scandinavian Defense: Mieses-Kotroc Variation
1590,1380,57,mate,white,210,B01,Scandinavian Defense: Mieses-Kotroc Variation
1741,1371,145,mate,white,370,B01,Scandinavian Defense: Mieses-Kotroc Variation
1321,1267,51,mate,white,54,B01,Scandinavian Defense: Mieses-Kotroc Variation
1324,1280,107,mate,white,44,B01,Scandinavian Defense: Mieses-Kotroc Variation
1303,1406,179,mate,white,103,B01,Scandinavian Defense: Mieses-Kotroc Variation
1799,1866,21,resign,white,67,B01,Scandinavian Defense: Mieses-Kotroc Variation
1940,1879,93,resign,white,61,B01,Scandinavian Defense: Mieses-Kotroc Variation
1757,1891,73,resign,white,134,B01,Scandinavian Defense: Mieses-Kotroc Variation
1378,1276,81,mate,white,102,B01,Scandinavian Defense: Mieses-Kotroc Variation
1373,1084,33,mate,white,289,B01,Scandinavian Defense: Mieses-Kotroc Variation
1306,1546,19,resign,white,240,B01,Scandinavian Defense: Mieses-Kotroc Variation
2173,2189,7,resign,white,16,B01,Scandinavian Defense: Mieses-Kotroc Variation
1477,1590,87,time,white,113,B01,Scandinavian Defense: Mieses-Kotroc Variation
1939,1619,65,resign,white,320,B01,Scandinavian Defense: Mieses-Kotroc Variation
1558,1551,33,resign,white,7,B01,Scandinavian Defense: Mieses-Kotroc Variation
1496,1489,35,mate,white,7,B01,Scandinavian Defense: Mieses-Kotroc Variation
1862,1502,99,time,white,360,B01,Scandinavian Defense: Mieses-Kotroc Variation
1540,1569,43,resign,white,29,B01,Scandinavian Defense: Mieses-Kotroc Variation
1354,1557,43,mate,white,203,B01,Scandinavian Defense: Mieses-Kotroc Variation
1231,1516,47,mate,white,285,B01,Scandinavian Defense: Mieses-Kotroc Variation
1214,994,23,resign,white,220,B01,Scandinavian Defense: Mieses-Kotroc Variation
1636,1364,47,mate,white,272,B01,Scandinavian Defense: Mieses-Kotroc Variation
1971,1317,39,mate,white,654,B01,Scandinavian Defense: Mieses-Kotroc Variation
1210,1100,57,mate,white,110,B01,Scandinavian Defense: Mieses-Kotroc Variation
1641,1959,55,mate,white,318,B01,Scandinavian Defense: Mieses-Kotroc Variation
1652,1229,40,resign,white,423,B01,Scandinavian Defense: Mieses-Kotroc Variation
1680,1661,49,resign,white,19,B01,Scandinavian Defense: Mieses-Kotroc Variation
1564,1318,59,mate,white,246,B01,Scandinavian Defense: Mieses-Kotroc Variation
1346,1397,80,resign,white,51,B01,Scandinavian Defense: Mieses-Kotroc Variation
1699,1798,45,resign,white,99,B01,Scandinavian Defense: Mieses-Kotroc Variation
1685,1666,105,resign,white,19,B01,Scandinavian Defense: Mieses-Kotroc Variation
1702,1421,127,mate,white,281,B01,Scandinavian Defense: Mieses-Kotroc Variation
1842,1703,7,resign,white,139,B01,Scandinavian Defense: Mieses-Kotroc Variation
1579,1565,89,mate,white,14,B01,Scandinavian Defense: Mieses-Kotroc Variation
1450,1195,59,mate,white,255,B01,Scandinavian Defense: Mieses-Kotroc Variation
1752,1740,11,resign,white,12,B01,Scandinavian Defense: Mieses-Kotroc Variation
2063,2065,33,resign,white,2,B01,Scandinavian Defense: Mieses-Kotroc Variation
2120,2055,55,resign,white,65,B01,Scandinavian Defense: Mieses-Kotroc Variation
1712,1499,55,resign,white,213,B01,Scandinavian Defense: Mieses-Kotroc Variation
1329,1303,109,mate,white,26,B01,Scandinavian Defense: Mieses-Kotroc Variation
1682,1206,29,resign,white,476,B01,Scandinavian Defense: Mieses-Kotroc Variation
1256,1164,81,mate,white,92,B01,Scandinavian Defense: Mieses-Kotroc Variation
1861,1066,7,resign,white,795,B01,Scandinavian Defense: Mieses-Kotroc Variation
1925,1698,17,resign,white,227,B01,Scandinavian Defense: Mieses-Kotroc Variation
1500,1451,23,mate,white,49,B01,Scandinavian Defense: Mieses-Kotroc Variation
1390,1386,51,resign,white,4,B01,Scandinavian Defense: Mieses-Kotroc Variation
1269,1205,23,resign,white,64,B01,Scandinavian Defense: Mieses-Kotroc Variation
2222,1382,7,resign,white,840,B01,Scandinavian Defense: Mieses-Kotroc Variation
1429,1467,99,time,white,38,B01,Scandinavian Defense: Mieses-Kotroc Variation
1685,1504,55,mate,white,181,B01,Scandinavian Defense: Mieses-Kotroc Variation
1504,1398,61,mate,white,106,B01,Scandinavian Defense: Mieses-Kotroc Variation
1636,1601,47,mate,white,35,B01,Scandinavian Defense: Mieses-Kotroc Variation
1222,1314,99,resign,white,92,B01,Scandinavian Defense: Mieses-Kotroc Variation
1876,1856,55,resign,white,20,B01,Scandinavian Defense: Modern Variation #2
1161,958,101,mate,white,203,B01,Scandinavian Defense: Modern Variation #2
1848,2264,125,resign,white,416,B01,Scandinavian Defense: Modern Variation #2
2056,2264,137,resign,white,208,B01,Scandinavian Defense: Modern Variation #2
1666,1556,113,resign,white,110,B01,Scandinavian Defense: Modern Variation #2
1728,1549,17,mate,white,179,B01,Scandinavian Defense: Modern Variation #2
1449,1331,119,mate,white,118,B01,Scandinavian Defense: Modern Variation #2
1903,1985,19,resign,white,82,B01,Scandinavian Defense: Modern Variation #2
1920,2004,87,resign,white,84,B01,Scandinavian Defense: Modern Variation #2
1929,2037,61,resign,white,108,B01,Scandinavian Defense: Modern Variation #2
2173,2118,75,resign,white,55,B01,Scandinavian Defense: Modern Variation |  Gipslis Variation
2213,1900,85,resign,white,313,B01,Scandinavian Defense: Modern Variation |  Gipslis Variation
1500,1549,47,resign,white,49,B01,Scandinavian Defense: Modern Variation |  Gipslis Variation
1724,1855,75,time,white,131,C45,Scotch Game
1350,1265,33,resign,white,85,C44,Scotch Game
1184,1184,61,resign,white,0,C44,Scotch Game
1329,1271,73,mate,white,58,C44,Scotch Game
2009,1441,23,mate,white,568,C44,Scotch Game
1512,1403,15,mate,white,109,C44,Scotch Game
1435,1429,65,resign,white,6,C44,Scotch Game
1371,1291,21,time,white,80,C44,Scotch Game
1083,1218,23,mate,white,135,C44,Scotch Game
1236,1098,37,mate,white,138,C45,Scotch Game
1308,1079,65,mate,white,229,C44,Scotch Game
1686,1400,117,mate,white,286,C45,Scotch Game
1270,953,31,mate,white,317,C44,Scotch Game
1545,1500,35,resign,white,45,C44,Scotch Game
1514,1108,65,mate,white,406,C44,Scotch Game
1825,1463,23,resign,white,362,C45,Scotch Game
1344,1961,61,resign,white,617,C45,Scotch Game
1201,1180,19,resign,white,21,C44,Scotch Game
1492,1173,31,resign,white,319,C44,Scotch Game
1180,1358,13,mate,white,178,C45,Scotch Game
1498,1677,47,mate,white,179,C45,Scotch Game
918,996,9,resign,white,78,C44,Scotch Game
1277,1255,137,mate,white,22,C44,Scotch Game
1330,1320,58,resign,white,10,C44,Scotch Game
1417,1213,15,mate,white,204,C44,Scotch Game
1445,1172,63,resign,white,273,C44,Scotch Game
1561,1166,41,mate,white,395,C44,Scotch Game
1765,1761,29,resign,white,4,C44,Scotch Game
1645,1353,85,mate,white,292,C44,Scotch Game
1747,1392,37,resign,white,355,C44,Scotch Game
1475,1177,23,resign,white,298,C45,Scotch Game
1308,1190,69,mate,white,118,C45,Scotch Game
1611,1443,25,mate,white,168,C45,Scotch Game
1653,1684,49,time,white,31,C44,Scotch Game
1649,1445,27,mate,white,204,C45,Scotch Game
1528,1517,49,resign,white,11,C44,Scotch Game
1326,1141,67,resign,white,185,C44,Scotch Game
1307,1381,37,mate,white,74,C44,Scotch Game
1269,1338,56,resign,white,69,C44,Scotch Game
1266,1295,39,resign,white,29,C45,Scotch Game
1532,1640,75,time,white,108,C44,Scotch Game
1547,1555,83,mate,white,8,C44,Scotch Game
1655,1499,93,time,white,156,C44,Scotch Game
1935,1631,35,resign,white,304,C45,Scotch Game
1614,1571,37,mate,white,43,C45,Scotch Game
1460,1460,57,mate,white,0,C45,Scotch Game
1977,1564,47,resign,white,413,C44,Scotch Game
1939,1781,39,resign,white,158,C44,Scotch Game
1724,1500,73,resign,white,224,C44,Scotch Game
1420,1591,29,resign,white,171,C45,Scotch Game
1436,1472,119,resign,white,36,C44,Scotch Game
1342,1580,79,mate,white,238,C45,Scotch Game
1756,1771,57,resign,white,15,C44,Scotch Game: Benima Defense
1805,1536,47,resign,white,269,C44,Scotch Game: Benima Defense
1562,1605,23,mate,white,43,C44,Scotch Game: Benima Defense
1705,1636,49,mate,white,69,C45,Scotch Game: Classical Variation
2161,1984,83,resign,white,177,C45,Scotch Game: Classical Variation
2062,1978,55,resign,white,84,C45,Scotch Game: Classical Variation
1247,1380,47,mate,white,133,C45,Scotch Game: Classical Variation
1369,1611,11,resign,white,242,C45,Scotch Game: Classical Variation
2100,1798,69,mate,white,302,C45,Scotch Game: Classical Variation
1888,1702,81,mate,white,186,C45,Scotch Game: Classical Variation
1666,1663,45,resign,white,3,C45,Scotch Game: Classical Variation
1218,1841,43,resign,white,623,C45,Scotch Game: Classical Variation
2230,1929,43,mate,white,301,C45,Scotch Game: Classical Variation
1795,1700,119,mate,white,95,C45,Scotch Game: Classical Variation
1570,1507,65,resign,white,63,C45,Scotch Game: Classical Variation
1991,1374,13,resign,white,617,C45,Scotch Game: Classical Variation
1825,1079,43,resign,white,746,C45,Scotch Game: Haxo Gambit
1840,1564,111,resign,white,276,C45,Scotch Game: Haxo Gambit
2134,1667,19,resign,white,467,C45,Scotch Game: Haxo Gambit
2185,1916,25,resign,white,269,C45,Scotch Game: Horwitz Attack
1583,1767,81,time,white,184,C44,Scotch Game: Lolli Variation
2099,1627,61,mate,white,472,C44,Scotch Game: Lolli Variation
2018,1923,67,resign,white,95,C45,Scotch Game: Malaniuk Variation
2422,2324,43,resign,white,98,C45,Scotch Game: Mieses Variation
2230,1942,35,time,white,288,C45,Scotch Game: Mieses Variation
2336,1830,39,resign,white,506,C45,Scotch Game: Potter Variation
1297,1319,91,mate,white,22,C45,Scotch Game: Schmidt Variation
1689,1556,47,resign,white,133,C45,Scotch Game: Schmidt Variation
1577,1567,71,resign,white,10,C45,Scotch Game: Schmidt Variation
1692,1678,157,mate,white,14,C45,Scotch Game: Schmidt Variation
1425,1342,75,resign,white,83,C45,Scotch Game: Schmidt Variation
1962,1935,35,mate,white,27,C45,Scotch Game: Schmidt Variation
1541,1465,153,mate,white,76,C45,Scotch Game: Schmidt Variation
1441,1464,39,mate,white,23,C45,Scotch Game: Schmidt Variation
2240,1677,36,resign,white,563,C45,Scotch Game: Schmidt Variation
1742,1785,41,time,white,43,C44,Scotch Game: Scotch Gambit
2001,1571,17,resign,white,430,C44,Scotch Game: Scotch Gambit
2194,2007,81,resign,white,187,C44,Scotch Game: Scotch Gambit
1999,1590,31,resign,white,409,C44,Scotch Game: Scotch Gambit
1426,1447,54,resign,white,21,C44,Scotch Game: Scotch Gambit |  Cochrane-Anderssen Variation
1469,1485,59,mate,white,16,C44,Scotch Game: Scotch Gambit |  Dubois Reti Defense
1470,1531,35,mate,white,61,C44,Scotch Game: Scotch Gambit |  Sarratt Variation
1609,2109,107,resign,white,500,D43,Semi-Slav Defense
1872,1708,89,resign,white,164,D43,Semi-Slav Defense
1351,1052,19,resign,white,299,D43,Semi-Slav Defense
1868,1519,69,mate,white,349,D43,Semi-Slav Defense
1739,1412,103,resign,white,327,D43,Semi-Slav Defense
1955,1890,30,resign,white,65,D43,Semi-Slav Defense
1907,1677,73,time,white,230,D31,Semi-Slav Defense: Accelerated Move Order
1689,1417,31,resign,white,272,D31,Semi-Slav Defense: Accelerated Move Order
1957,1688,45,resign,white,269,D31,Semi-Slav Defense: Accelerated Move Order
1643,1611,47,resign,white,32,D44,Semi-Slav Defense: Anti-Moscow Gambit
1687,1691,59,resign,white,4,D46,Semi-Slav Defense: Bogoljubov Variation
1568,1549,51,resign,white,19,D46,Semi-Slav Defense: Chigorin Defense
2235,2118,45,resign,white,117,D46,Semi-Slav Defense: Chigorin Defense
1758,1725,95,mate,white,33,D45,Semi-Slav Defense: Main Line
1413,1419,69,mate,white,6,D45,Semi-Slav Defense: Main Line
2276,2057,54,resign,white,219,D47,Semi-Slav Defense: Meran Variation |  Wade Variation
2277,2235,63,resign,white,42,D45,Semi-Slav Defense: Normal Variation
1728,1527,33,resign,white,201,D31,Semi-Slav Defense: Noteboom Variation
1436,1439,51,mate,white,3,D46,Semi-Slav Defense: Romih Variation
1203,1019,54,resign,white,184,B27,Sicilian Defense
1885,1856,107,resign,white,29,B50,Sicilian Defense
1895,1859,105,time,white,36,B50,Sicilian Defense
1513,1456,29,mate,white,57,B54,Sicilian Defense
1211,1230,75,resign,white,19,B20,Sicilian Defense
1344,1500,61,mate,white,156,B50,Sicilian Defense
1392,1500,43,mate,white,108,B20,Sicilian Defense
1706,1695,49,resign,white,11,B20,Sicilian Defense
1819,2020,63,mate,white,201,B27,Sicilian Defense
1217,1176,23,mate,white,41,B20,Sicilian Defense
1258,1331,32,resign,white,73,B20,Sicilian Defense
1946,1828,63,resign,white,118,B50,Sicilian Defense
1717,1833,71,resign,white,116,B50,Sicilian Defense
1770,1789,38,resign,white,19,B50,Sicilian Defense
1268,1312,151,time,white,44,B20,Sicilian Defense
1372,1003,11,resign,white,369,B50,Sicilian Defense
1403,1428,105,resign,white,25,B20,Sicilian Defense
1789,1695,47,resign,white,94,B50,Sicilian Defense
1456,1472,89,mate,white,16,B50,Sicilian Defense
1465,1472,51,resign,white,7,B20,Sicilian Defense
1471,1454,96,resign,white,17,B20,Sicilian Defense
1417,1477,81,resign,white,60,B50,Sicilian Defense
2129,2088,93,resign,white,41,B50,Sicilian Defense
1670,1744,63,mate,white,74,B50,Sicilian Defense
1664,1568,59,resign,white,96,B50,Sicilian Defense
1859,1541,51,resign,white,318,B50,Sicilian Defense
1805,1548,101,resign,white,257,B50,Sicilian Defense
1809,1700,77,mate,white,109,B20,Sicilian Defense
1422,1469,61,resign,white,47,B20,Sicilian Defense
1482,1537,63,resign,white,55,B20,Sicilian Defense
2013,1773,37,resign,white,240,B54,Sicilian Defense
1618,1136,23,mate,white,482,B20,Sicilian Defense
1651,1550,147,mate,white,101,B20,Sicilian Defense
1681,1388,24,resign,white,293,B50,Sicilian Defense
1307,1518,65,mate,white,211,B50,Sicilian Defense
1709,1334,67,time,white,375,B54,Sicilian Defense
1575,1566,71,resign,white,9,B50,Sicilian Defense
1962,1901,63,resign,white,61,B50,Sicilian Defense
1708,1918,40,resign,white,210,B50,Sicilian Defense
1385,1470,40,resign,white,85,B20,Sicilian Defense
1391,1202,20,resign,white,189,B20,Sicilian Defense
1647,1678,49,resign,white,31,B50,Sicilian Defense
1799,1684,61,time,white,115,B50,Sicilian Defense
1500,1694,61,time,white,194,B50,Sicilian Defense
1398,1265,73,mate,white,133,B20,Sicilian Defense
1552,1270,17,resign,white,282,B50,Sicilian Defense
1741,1849,89,resign,white,108,B50,Sicilian Defense
1451,1450,45,resign,white,1,B20,Sicilian Defense
1496,1568,31,time,white,72,B50,Sicilian Defense
1425,1589,61,resign,white,164,B20,Sicilian Defense
1370,1600,37,resign,white,230,B50,Sicilian Defense
1500,1605,33,resign,white,105,B50,Sicilian Defense
1491,1541,41,resign,white,50,B20,Sicilian Defense
1490,969,23,resign,white,521,B20,Sicilian Defense
1688,1421,13,resign,white,267,B27,Sicilian Defense
1667,1456,43,resign,white,211,B54,Sicilian Defense
1856,1651,43,resign,white,205,B50,Sicilian Defense
1485,1557,15,resign,white,72,B20,Sicilian Defense
2191,1884,57,resign,white,307,B20,Sicilian Defense
2184,1891,65,resign,white,293,B20,Sicilian Defense
1719,1341,37,resign,white,378,B54,Sicilian Defense
1373,1518,34,resign,white,145,B20,Sicilian Defense
1401,1626,57,mate,white,225,B20,Sicilian Defense
1663,1391,15,mate,white,272,B50,Sicilian Defense
1832,1520,42,resign,white,312,B50,Sicilian Defense
1783,1450,69,mate,white,333,B50,Sicilian Defense
1499,1493,67,mate,white,6,B50,Sicilian Defense
1470,1409,63,mate,white,61,B50,Sicilian Defense
1404,1013,91,resign,white,391,B20,Sicilian Defense
1617,1022,37,mate,white,595,B50,Sicilian Defense
1209,1237,45,resign,white,28,B20,Sicilian Defense
1081,1213,31,mate,white,132,B27,Sicilian Defense
1467,1426,91,mate,white,41,B54,Sicilian Defense #2
1906,1902,77,resign,white,4,B54,Sicilian Defense #2
1462,1424,67,resign,white,38,B54,Sicilian Defense #2
2115,1945,31,resign,white,170,B54,Sicilian Defense #2
1826,1851,73,mate,white,25,B54,Sicilian Defense #2
1755,1647,65,resign,white,108,B54,Sicilian Defense #2
1730,1718,59,mate,white,12,B54,Sicilian Defense #2
1537,1464,33,time,white,73,B54,Sicilian Defense #2
1808,1515,49,resign,white,293,B54,Sicilian Defense #2
1492,1483,45,resign,white,9,B54,Sicilian Defense #2
1416,1438,77,mate,white,22,B54,Sicilian Defense #2
1088,1217,76,resign,white,129,B54,Sicilian Defense #2
1944,1776,39,resign,white,168,B36,Sicilian Defense: Accelerated Dragon
1645,1525,91,resign,white,120,B34,Sicilian Defense: Accelerated Dragon
1500,1404,45,resign,white,96,B36,Sicilian Defense: Accelerated Dragon
2162,1278,51,resign,white,884,B34,Sicilian Defense: Accelerated Dragon |  Exchange Variation
1541,1586,67,mate,white,45,B34,Sicilian Defense: Accelerated Dragon |  Modern Variation
2257,1922,55,mate,white,335,B34,Sicilian Defense: Accelerated Dragon |  Modern Variation
2078,1920,47,resign,white,158,B34,Sicilian Defense: Accelerated Dragon |  Modern Variation
1514,1547,21,resign,white,33,B34,Sicilian Defense: Accelerated Dragon |  Modern Variation
2202,1915,52,resign,white,287,B34,Sicilian Defense: Accelerated Dragon |  Modern Variation
1625,1212,67,time,white,413,B34,Sicilian Defense: Accelerated Dragon |  Modern Variation
1624,1486,63,mate,white,138,B34,Sicilian Defense: Accelerated Dragon |  Modern Variation
1578,1475,33,resign,white,103,B34,Sicilian Defense: Accelerated Dragon |  Modern Variation
1567,1551,28,resign,white,16,B22,Sicilian Defense: Alapin Variation
1724,1605,39,resign,white,119,B22,Sicilian Defense: Alapin Variation
1732,1759,21,resign,white,27,B22,Sicilian Defense: Alapin Variation
1512,1490,9,mate,white,22,B22,Sicilian Defense: Alapin Variation
1778,1722,79,time,white,56,B22,Sicilian Defense: Alapin Variation
1470,1545,62,resign,white,75,B22,Sicilian Defense: Alapin Variation
1556,1453,55,mate,white,103,B22,Sicilian Defense: Alapin Variation
1795,1707,51,mate,white,88,B22,Sicilian Defense: Alapin Variation
1534,1397,85,mate,white,137,B22,Sicilian Defense: Alapin Variation
1968,1921,22,resign,white,47,B22,Sicilian Defense: Alapin Variation |  Barmen Defense
1874,1939,149,mate,white,65,B22,Sicilian Defense: Alapin Variation |  Smith-Morra Declined
1302,1351,7,resign,white,49,B20,Sicilian Defense: Amazon Attack
1432,1559,20,resign,white,127,B20,Sicilian Defense: Bowdler Attack
1543,1553,120,resign,white,10,B20,Sicilian Defense: Bowdler Attack
1605,1367,72,resign,white,238,B20,Sicilian Defense: Bowdler Attack
1825,1885,57,resign,white,60,B20,Sicilian Defense: Bowdler Attack
1859,1954,151,time,white,95,B20,Sicilian Defense: Bowdler Attack
1785,1971,119,resign,white,186,B20,Sicilian Defense: Bowdler Attack
1556,1410,37,resign,white,146,B20,Sicilian Defense: Bowdler Attack
1451,1451,66,resign,white,0,B20,Sicilian Defense: Bowdler Attack
1510,1483,21,resign,white,27,B20,Sicilian Defense: Bowdler Attack
1525,1501,27,resign,white,24,B20,Sicilian Defense: Bowdler Attack
1493,1439,61,resign,white,54,B20,Sicilian Defense: Bowdler Attack
1651,1737,61,resign,white,86,B20,Sicilian Defense: Bowdler Attack
1370,1558,37,resign,white,188,B20,Sicilian Defense: Bowdler Attack
1701,1575,37,resign,white,126,B20,Sicilian Defense: Bowdler Attack
1663,1565,63,resign,white,98,B20,Sicilian Defense: Bowdler Attack
1644,1574,59,mate,white,70,B20,Sicilian Defense: Bowdler Attack
1523,1538,89,resign,white,15,B20,Sicilian Defense: Bowdler Attack
1447,1581,44,resign,white,134,B20,Sicilian Defense: Bowdler Attack
1493,1517,25,resign,white,24,B20,Sicilian Defense: Bowdler Attack
1504,1509,31,resign,white,5,B20,Sicilian Defense: Bowdler Attack
1501,1486,117,resign,white,15,B20,Sicilian Defense: Bowdler Attack
1489,1478,33,resign,white,11,B20,Sicilian Defense: Bowdler Attack
1536,1471,26,resign,white,65,B20,Sicilian Defense: Bowdler Attack
1471,1461,89,mate,white,10,B20,Sicilian Defense: Bowdler Attack
1912,1827,55,resign,white,85,B20,Sicilian Defense: Bowdler Attack
1983,1764,45,resign,white,219,B20,Sicilian Defense: Bowdler Attack
1971,1184,20,resign,white,787,B20,Sicilian Defense: Bowdler Attack
1536,1459,87,resign,white,77,B20,Sicilian Defense: Bowdler Attack
1555,1447,68,resign,white,108,B20,Sicilian Defense: Bowdler Attack
1427,1165,49,resign,white,262,B20,Sicilian Defense: Bowdler Attack
1748,1689,113,time,white,59,B20,Sicilian Defense: Bowdler Attack
1643,1355,43,resign,white,288,B20,Sicilian Defense: Bowdler Attack
1751,1805,57,mate,white,54,B20,Sicilian Defense: Bowdler Attack
1964,1913,41,resign,white,51,B20,Sicilian Defense: Bowdler Attack
1803,1500,111,mate,white,303,B20,Sicilian Defense: Bowdler Attack
1231,1531,39,resign,white,300,B20,Sicilian Defense: Bowdler Attack
1541,1548,71,resign,white,7,B20,Sicilian Defense: Bowdler Attack
1493,1498,45,mate,white,5,B20,Sicilian Defense: Bowdler Attack
1816,1872,104,resign,white,56,B20,Sicilian Defense: Bowdler Attack
1330,1403,69,mate,white,73,B20,Sicilian Defense: Bowdler Attack
1548,1458,79,mate,white,90,B20,Sicilian Defense: Bowdler Attack
1607,1554,32,resign,white,53,B20,Sicilian Defense: Bowdler Attack
1470,1001,7,mate,white,469,B20,Sicilian Defense: Bowdler Attack
1240,982,9,mate,white,258,B20,Sicilian Defense: Bowdler Attack
1788,1665,91,time,white,123,B20,Sicilian Defense: Bowdler Attack
1527,1501,119,resign,white,26,B20,Sicilian Defense: Bowdler Attack
1772,1520,36,resign,white,252,B20,Sicilian Defense: Bowdler Attack
1706,1405,135,mate,white,301,B20,Sicilian Defense: Bowdler Attack
1500,1482,21,mate,white,18,B20,Sicilian Defense: Bowdler Attack
1470,1397,97,mate,white,73,B20,Sicilian Defense: Bowdler Attack
1627,1661,61,resign,white,34,B20,Sicilian Defense: Bowdler Attack
1448,1632,77,time,white,184,B20,Sicilian Defense: Bowdler Attack
1605,2114,151,time,white,509,B20,Sicilian Defense: Bowdler Attack
1300,1333,41,mate,white,33,B52,Sicilian Defense: Canal Attack |  Main Line
1434,1321,61,mate,white,113,B52,Sicilian Defense: Canal Attack |  Main Line
1446,1448,21,mate,white,2,B52,Sicilian Defense: Canal Attack |  Main Line
1282,1428,35,resign,white,146,B52,Sicilian Defense: Canal Attack |  Main Line
2263,2253,93,resign,white,10,B52,Sicilian Defense: Canal Attack |  Main Line
1646,1673,53,resign,white,27,B52,Sicilian Defense: Canal Attack |  Main Line
1828,1848,34,resign,white,20,B51,Sicilian Defense: Canal-Sokolsky Attack
1341,1434,59,mate,white,93,B51,Sicilian Defense: Canal-Sokolsky Attack
2197,1943,45,resign,white,254,B51,Sicilian Defense: Canal-Sokolsky Attack
1626,1384,71,mate,white,242,B53,Sicilian Defense: Chekhover Variation
1693,1666,121,mate,white,27,B53,Sicilian Defense: Chekhover Variation
1937,1959,119,mate,white,22,B53,Sicilian Defense: Chekhover Variation
1819,1881,36,resign,white,62,B56,Sicilian Defense: Classical Variation
1436,1484,75,resign,white,48,B56,Sicilian Defense: Classical Variation
2320,2013,42,resign,white,307,B58,Sicilian Defense: Classical Variation
2118,2004,39,resign,white,114,B23,Sicilian Defense: Closed
1500,1793,51,resign,white,293,B23,Sicilian Defense: Closed
1758,1387,39,mate,white,371,B23,Sicilian Defense: Closed #2
2347,1906,25,resign,white,441,B24,Sicilian Defense: Closed #2
1407,1500,3,resign,white,93,B23,Sicilian Defense: Closed Variation
1296,1284,25,resign,white,12,B23,Sicilian Defense: Closed Variation
1258,1362,73,mate,white,104,B23,Sicilian Defense: Closed Variation
1188,1259,64,resign,white,71,B23,Sicilian Defense: Closed Variation
1218,1266,33,mate,white,48,B23,Sicilian Defense: Closed Variation
1491,1493,59,resign,white,2,B23,Sicilian Defense: Closed Variation
1347,1395,57,mate,white,48,B23,Sicilian Defense: Closed Variation
1645,1664,71,resign,white,19,B23,Sicilian Defense: Closed Variation
1681,1738,11,resign,white,57,B23,Sicilian Defense: Closed Variation
1609,1534,63,resign,white,75,B23,Sicilian Defense: Closed Variation
1713,1738,109,resign,white,25,B23,Sicilian Defense: Closed Variation
2242,2305,77,resign,white,63,B25,Sicilian Defense: Closed Variation
1317,1423,79,resign,white,106,B23,Sicilian Defense: Closed Variation
1864,1805,81,resign,white,59,B24,Sicilian Defense: Closed Variation |  Fianchetto Variation
1901,1613,59,resign,white,288,B24,Sicilian Defense: Closed Variation |  Fianchetto Variation
1399,1449,69,mate,white,50,B25,Sicilian Defense: Closed Variation |  Traditional
1547,1604,105,mate,white,57,B25,Sicilian Defense: Closed Variation |  Traditional
2005,2151,43,mate,white,146,B25,Sicilian Defense: Closed Variation |  Traditional
1569,1542,55,mate,white,27,B25,Sicilian Defense: Closed Variation |  Traditional
1555,1711,83,mate,white,156,B25,Sicilian Defense: Closed Variation |  Traditional
1673,1546,67,resign,white,127,B25,Sicilian Defense: Closed Variation |  Traditional
1663,1790,25,mate,white,127,B25,Sicilian Defense: Closed Variation |  Traditional
1697,1955,36,resign,white,258,B25,Sicilian Defense: Closed Variation |  Traditional
1774,2003,57,resign,white,229,B25,Sicilian Defense: Closed Variation |  Traditional
2074,2121,33,resign,white,47,B25,Sicilian Defense: Closed Variation |  Traditional
1613,1694,119,resign,white,81,B50,Sicilian Defense: Delayed Alapin
2351,2363,161,mate,white,12,B50,Sicilian Defense: Delayed Alapin
1497,1462,91,time,white,35,B50,Sicilian Defense: Delayed Alapin
1832,1762,133,mate,white,70,B50,Sicilian Defense: Delayed Alapin
1742,1739,95,time,white,3,B40,Sicilian Defense: Delayed Alapin Variation
1201,1290,89,mate,white,89,B70,Sicilian Defense: Dragon Variation
1343,1276,71,mate,white,67,B70,Sicilian Defense: Dragon Variation
2194,2232,79,mate,white,38,B72,Sicilian Defense: Dragon Variation |  Classical Variation #2
2121,2234,67,mate,white,113,B74,Sicilian Defense: Dragon Variation |  Classical Variation |  Normal Line
1921,1815,49,resign,white,106,B71,Sicilian Defense: Dragon Variation |  Levenfish Variation
1655,1662,73,resign,white,7,B75,Sicilian Defense: Dragon Variation |  Yugoslav Attack |  Early Deviations
2279,2255,61,resign,white,24,B76,Sicilian Defense: Dragon Variation |  Yugoslav Attack |  Panov Variation
2232,2252,71,resign,white,20,B72,Sicilian Defense: Dragon |  6.Be3
1575,1567,59,resign,white,8,B72,Sicilian Defense: Dragon |  Classical Attack
1484,1378,95,resign,white,106,B40,Sicilian Defense: Drazic Variation
2131,2018,55,resign,white,113,B45,Sicilian Defense: Four Knights Variation
1563,1318,31,resign,white,245,B32,Sicilian Defense: Franco-Sicilian Variation
2165,1973,25,mate,white,192,B32,Sicilian Defense: Franco-Sicilian Variation
1464,1310,33,resign,white,154,B32,Sicilian Defense: Franco-Sicilian Variation
1461,1532,43,resign,white,71,B32,Sicilian Defense: Franco-Sicilian Variation
1550,1571,74,resign,white,21,B32,Sicilian Defense: Franco-Sicilian Variation
1608,1794,75,resign,white,186,B32,Sicilian Defense: Franco-Sicilian Variation
1650,1910,53,resign,white,260,B40,Sicilian Defense: French Variation
1679,1730,61,mate,white,51,B40,Sicilian Defense: French Variation
1190,1261,29,mate,white,71,B40,Sicilian Defense: French Variation
1545,1393,57,resign,white,152,B40,Sicilian Defense: French Variation
1453,1316,15,resign,white,137,B40,Sicilian Defense: French Variation
1639,1656,109,time,white,17,B40,Sicilian Defense: French Variation
1661,1694,37,resign,white,33,B40,Sicilian Defense: French Variation
1472,1450,61,time,white,22,B40,Sicilian Defense: French Variation
1603,1339,41,mate,white,264,B40,Sicilian Defense: French Variation
1685,1387,33,mate,white,298,B40,Sicilian Defense: French Variation
1538,1660,89,resign,white,122,B40,Sicilian Defense: French Variation |  Open
2004,1881,35,mate,white,123,B40,Sicilian Defense: French Variation |  Westerinen Attack
2189,1868,46,resign,white,321,B40,Sicilian Defense: French Variation |  Westerinen Attack
1851,1918,125,resign,white,67,B27,Sicilian Defense: Hyperaccelerated Dragon
1421,985,37,resign,white,436,B27,Sicilian Defense: Hyperaccelerated Dragon
1561,1589,75,time,white,28,A42,Sicilian Defense: Hyperaccelerated Fianchetto
2294,1742,57,resign,white,552,B27,Sicilian Defense: Hyperaccelerated Pterodactyl
1915,1835,65,resign,white,80,B27,Sicilian Defense: Jalalabad Variation
1302,1349,76,resign,white,47,B27,Sicilian Defense: Jalalabad Variation
1283,1107,45,resign,white,176,B27,Sicilian Defense: Jalalabad Variation
1860,1800,71,mate,white,60,B32,Sicilian Defense: Kalashnikov Variation
1754,1768,41,mate,white,14,B32,Sicilian Defense: Kalashnikov Variation
2131,2103,77,resign,white,28,B32,Sicilian Defense: Kalashnikov Variation
1930,1850,33,resign,white,80,B32,Sicilian Defense: Kalashnikov Variation
2089,2003,81,time,white,86,B32,Sicilian Defense: Kalashnikov Variation
1864,1892,43,resign,white,28,B41,Sicilian Defense: Kan Variation
1996,1957,65,mate,white,39,B43,Sicilian Defense: Kan Variation |  Knight Variation
2264,1778,41,resign,white,486,B43,Sicilian Defense: Kan Variation |  Knight Variation
1705,1635,51,mate,white,70,B43,Sicilian Defense: Kan Variation |  Knight Variation
2270,1908,45,resign,white,362,B42,Sicilian Defense: Kan Variation |  Modern Variation
1421,1430,53,resign,white,9,B40,Sicilian Defense: Kramnik Variation
1548,1535,43,resign,white,13,B20,Sicilian Defense: Lasker-Dunne Attack
1153,1330,23,resign,white,177,B20,Sicilian Defense: Lasker-Dunne Attack
1511,1393,25,resign,white,118,B33,Sicilian Defense: Lasker-Pelikan Variation
1640,1447,65,mate,white,193,B33,Sicilian Defense: Lasker-Pelikan Variation |  Retreat Variation
1723,1814,26,resign,white,91,B33,Sicilian Defense: Lasker-Pelikan Variation |  Schlechter Variation
2469,2216,57,resign,white,253,B33,Sicilian Defense: Lasker-Pelikan Variation |  Schlechter Variation
1932,1948,27,resign,white,16,B33,Sicilian Defense: Lasker-Pelikan Variation |  Schlechter Variation
1722,1605,23,resign,white,117,B32,Sicilian Defense: Loewenthal Variation
1568,1696,33,resign,white,128,B32,Sicilian Defense: Loewenthal Variation
1455,1272,43,mate,white,183,B32,Sicilian Defense: Loewenthal Variation
1344,1478,99,resign,white,134,B32,Sicilian Defense: Loewenthal Variation
1571,1459,83,resign,white,112,B32,Sicilian Defense: Loewenthal Variation
1690,1533,77,resign,white,157,B32,Sicilian Defense: Loewenthal Variation
1998,1891,51,resign,white,107,B32,Sicilian Defense: Loewenthal Variation
1828,1884,33,resign,white,56,B21,Sicilian Defense: McDonnell Attack
2007,1966,111,resign,white,41,B21,Sicilian Defense: McDonnell Attack
1633,1604,30,resign,white,29,B21,Sicilian Defense: McDonnell Attack
1858,1814,97,mate,white,44,B21,Sicilian Defense: McDonnell Attack
1888,1831,53,time,white,57,B21,Sicilian Defense: McDonnell Attack
1951,1975,41,mate,white,24,B21,Sicilian Defense: McDonnell Attack
1962,1924,63,mate,white,38,B21,Sicilian Defense: McDonnell Attack
1613,1474,83,resign,white,139,B21,Sicilian Defense: McDonnell Attack
1788,1652,57,resign,white,136,B21,Sicilian Defense: McDonnell Attack
1414,1534,30,resign,white,120,B21,Sicilian Defense: McDonnell Attack
1519,1410,82,resign,white,109,B20,Sicilian Defense: Mengarini Variation
1462,1465,83,resign,white,3,B20,Sicilian Defense: Mengarini Variation
1549,1419,85,resign,white,130,B50,Sicilian Defense: Modern Variations |  Anti-Qxd4 Move Order
1263,1336,47,mate,white,73,B57,Sicilian Defense: Modern Variations |  Main Line
1829,1905,119,time,white,76,B57,Sicilian Defense: Modern Variations |  Main Line
1323,1281,47,mate,white,42,B57,Sicilian Defense: Modern Variations |  Main Line
1784,1972,169,mate,white,188,B57,Sicilian Defense: Modern Variations |  Main Line
1835,1582,25,mate,white,253,B21,Sicilian Defense: Morphy Gambit |  Andreaschek Gambit
1710,1712,93,resign,white,2,B95,Sicilian Defense: Najdorf Variation
1989,1980,113,time,white,9,B90,Sicilian Defense: Najdorf Variation
1480,1494,35,resign,white,14,B90,Sicilian Defense: Najdorf Variation
1392,1332,67,resign,white,60,B94,Sicilian Defense: Najdorf Variation
1757,1500,63,resign,white,257,B94,Sicilian Defense: Najdorf Variation
2135,1980,73,resign,white,155,B98,Sicilian Defense: Najdorf Variation
1502,1463,106,resign,white,39,B94,Sicilian Defense: Najdorf Variation
1776,1724,56,resign,white,52,B90,Sicilian Defense: Najdorf Variation
1811,1774,57,mate,white,37,B90,Sicilian Defense: Najdorf Variation
1844,1771,49,resign,white,73,B90,Sicilian Defense: Najdorf Variation
1594,1608,39,resign,white,14,B90,Sicilian Defense: Najdorf Variation
1621,1738,24,resign,white,117,B90,Sicilian Defense: Najdorf Variation
1660,1536,43,resign,white,124,B90,Sicilian Defense: Najdorf Variation
2261,1940,67,resign,white,321,B95,Sicilian Defense: Najdorf Variation
1776,1401,107,mate,white,375,B90,Sicilian Defense: Najdorf Variation
1849,1874,77,mate,white,25,B90,Sicilian Defense: Najdorf Variation |  Adams Attack
1889,1807,109,time,white,82,B93,Sicilian Defense: Najdorf Variation |  Amsterdam Variation
1776,1432,37,resign,white,344,B93,Sicilian Defense: Najdorf Variation |  Amsterdam Variation
2209,2193,93,mate,white,16,B90,Sicilian Defense: Najdorf Variation |  English Attack
1570,1600,102,resign,white,30,B90,Sicilian Defense: Najdorf Variation |  English Attack
2022,1431,53,resign,white,591,B90,Sicilian Defense: Najdorf Variation |  English Attack
1669,1629,47,resign,white,40,B90,Sicilian Defense: Najdorf Variation |  English Attack
1975,1964,71,resign,white,11,B92,Sicilian Defense: Najdorf Variation |  Opocensky Variation
1949,1714,119,resign,white,235,B92,Sicilian Defense: Najdorf Variation |  Opocensky Variation
1606,1620,53,resign,white,14,B92,Sicilian Defense: Najdorf Variation |  Opocensky Variation
2175,1983,37,mate,white,192,B84,Sicilian Defense: Najdorf Variation |  Scheveningen Variation
2146,1645,67,resign,white,501,B91,Sicilian Defense: Najdorf Variation |  Zagreb (Fianchetto) Variation
1910,1862,41,mate,white,48,B90,Sicilian Defense: Najdorf |  Lipnitsky Attack
1846,1778,75,time,white,68,B90,Sicilian Defense: Najdorf |  Lipnitsky Attack
1309,1101,27,mate,white,208,B90,Sicilian Defense: Najdorf |  Lipnitsky Attack
1301,1318,75,mate,white,17,B29,Sicilian Defense: Nimzowitsch Variation
1256,1363,37,mate,white,107,B29,Sicilian Defense: Nimzowitsch Variation |  Advance Variation
1524,1416,121,mate,white,108,B29,Sicilian Defense: Nimzowitsch Variation |  Advance Variation
1767,1330,27,resign,white,437,B29,Sicilian Defense: Nimzowitsch Variation |  Closed Variation
1519,1348,105,resign,white,171,B29,Sicilian Defense: Nimzowitsch Variation |  Closed Variation
2333,2134,45,resign,white,199,B29,Sicilian Defense: Nimzowitsch Variation |  Main Line
1852,1852,65,time,white,0,B30,Sicilian Defense: Nyezhmetdinov-Rossolimo Attack
1631,1652,63,resign,white,21,B30,Sicilian Defense: Nyezhmetdinov-Rossolimo Attack
1864,1842,61,resign,white,22,B30,Sicilian Defense: Nyezhmetdinov-Rossolimo Attack
1544,1496,111,resign,white,48,B30,Sicilian Defense: Nyezhmetdinov-Rossolimo Attack
1341,1424,49,resign,white,83,B30,Sicilian Defense: Nyezhmetdinov-Rossolimo Attack
2167,1562,53,resign,white,605,B30,Sicilian Defense: Nyezhmetdinov-Rossolimo Attack
1429,1384,28,resign,white,45,B30,Sicilian Defense: Nyezhmetdinov-Rossolimo Attack
1734,1748,35,resign,white,14,B30,Sicilian Defense: Nyezhmetdinov-Rossolimo Attack
2307,2280,45,resign,white,27,B30,Sicilian Defense: Nyezhmetdinov-Rossolimo Attack
1813,1940,75,resign,white,127,B30,Sicilian Defense: Nyezhmetdinov-Rossolimo Attack
1525,1377,25,resign,white,148,B30,Sicilian Defense: Nyezhmetdinov-Rossolimo Attack
2211,1731,89,time,white,480,B30,Sicilian Defense: Nyezhmetdinov-Rossolimo Attack
1576,1767,17,mate,white,191,B30,Sicilian Defense: Nyezhmetdinov-Rossolimo Attack
1817,1839,121,resign,white,22,B30,Sicilian Defense: Nyezhmetdinov-Rossolimo Attack
1860,1863,35,resign,white,3,B30,Sicilian Defense: Nyezhmetdinov-Rossolimo Attack
2028,1971,67,time,white,57,B30,Sicilian Defense: Nyezhmetdinov-Rossolimo Attack
1776,1880,79,mate,white,104,B31,Sicilian Defense: Nyezhmetdinov-Rossolimo Attack |  Fianchetto Variation
1457,1395,33,resign,white,62,B31,Sicilian Defense: Nyezhmetdinov-Rossolimo Attack |  Fianchetto Variation
1465,1493,50,resign,white,28,B31,Sicilian Defense: Nyezhmetdinov-Rossolimo Attack |  Fianchetto Variation
2335,2262,45,mate,white,73,B31,Sicilian Defense: Nyezhmetdinov-Rossolimo Attack |  Fianchetto Variation
1821,1970,46,resign,white,149,B31,Sicilian Defense: Nyezhmetdinov-Rossolimo Attack |  Fianchetto Variation
1480,1815,19,resign,white,335,B28,Sicilian Defense: O'Kelly Variation |  Normal System |  Taimanov Line
1847,1822,51,mate,white,25,B28,Sicilian Defense: O'Kelly Variation |  Normal System |  Taimanov Line
2156,2181,101,resign,white,25,B28,Sicilian Defense: O'Kelly Variation |  Yerevan System
2215,2147,51,resign,white,68,B30,Sicilian Defense: Old Sicilian
1637,1661,141,mate,white,24,B30,Sicilian Defense: Old Sicilian
1810,1835,51,resign,white,25,B30,Sicilian Defense: Old Sicilian
1285,1116,30,resign,white,169,B30,Sicilian Defense: Old Sicilian
2145,1631,33,resign,white,514,B30,Sicilian Defense: Old Sicilian
1511,1502,37,resign,white,9,B30,Sicilian Defense: Old Sicilian
1532,1475,21,resign,white,57,B30,Sicilian Defense: Old Sicilian
1504,1509,35,resign,white,5,B30,Sicilian Defense: Old Sicilian
1609,1880,71,resign,white,271,B30,Sicilian Defense: Old Sicilian
1420,1465,71,resign,white,45,B30,Sicilian Defense: Old Sicilian
1771,1265,49,mate,white,506,B30,Sicilian Defense: Old Sicilian
1956,1574,75,mate,white,382,B30,Sicilian Defense: Old Sicilian
1604,1613,21,resign,white,9,B30,Sicilian Defense: Old Sicilian
1428,1437,128,resign,white,9,B30,Sicilian Defense: Old Sicilian
1507,1445,113,mate,white,62,B30,Sicilian Defense: Old Sicilian
1362,1463,35,mate,white,101,B30,Sicilian Defense: Old Sicilian
1394,1521,83,mate,white,127,B30,Sicilian Defense: Old Sicilian
1654,1693,49,mate,white,39,B30,Sicilian Defense: Old Sicilian
1906,2004,21,resign,white,98,B30,Sicilian Defense: Old Sicilian
2009,2004,67,resign,white,5,B30,Sicilian Defense: Old Sicilian
1759,1737,51,mate,white,22,B30,Sicilian Defense: Old Sicilian
1858,1718,7,resign,white,140,B30,Sicilian Defense: Old Sicilian
1842,2013,37,resign,white,171,B30,Sicilian Defense: Old Sicilian
1397,1643,95,time,white,246,B30,Sicilian Defense: Old Sicilian
2029,1389,31,resign,white,640,B30,Sicilian Defense: Old Sicilian
1541,1422,79,resign,white,119,B30,Sicilian Defense: Old Sicilian
1747,1962,75,mate,white,215,B30,Sicilian Defense: Old Sicilian
1914,1842,34,resign,white,72,B33,Sicilian Defense: Open
2196,2030,155,resign,white,166,B33,Sicilian Defense: Open
1576,1437,111,resign,white,139,B32,Sicilian Defense: Open
2195,1964,35,resign,white,231,B33,Sicilian Defense: Open
1574,1497,67,resign,white,77,B32,Sicilian Defense: Open
1938,1777,26,resign,white,161,B32,Sicilian Defense: Open
1610,1427,29,resign,white,183,B32,Sicilian Defense: Open
1837,1823,55,mate,white,14,B32,Sicilian Defense: Open #3
1525,1430,45,mate,white,95,B32,Sicilian Defense: Open #3
1321,1393,15,mate,white,72,B32,Sicilian Defense: Open #3
1340,1235,63,resign,white,105,B32,Sicilian Defense: Open #3
1442,1230,37,resign,white,212,B32,Sicilian Defense: Open #3
1669,1636,47,resign,white,33,B44,Sicilian Defense: Paulsen Variation
1778,1773,85,time,white,5,B44,Sicilian Defense: Paulsen Variation
1979,2008,55,resign,white,29,B47,Sicilian Defense: Paulsen Variation |  Bastrikov Variation
2202,2234,41,resign,white,32,B45,Sicilian Defense: Paulsen Variation |  Normal Variation
1898,1852,37,resign,white,46,B45,Sicilian Defense: Paulsen Variation |  Normal Variation
1643,1924,133,resign,white,281,B44,Sicilian Defense: Paulsen Variation |  Szen Variation
1832,1805,66,resign,white,27,B44,Sicilian Defense: Paulsen Variation |  Szen Variation
1976,1988,63,resign,white,12,B40,Sicilian Defense: Pin Variation
2040,1981,63,resign,white,59,B40,Sicilian Defense: Pin Variation
1611,1478,72,resign,white,133,B27,Sicilian Defense: Quinteros Variation
1462,1437,107,resign,white,25,B80,Sicilian Defense: Scheveningen Variation
1002,1412,36,resign,white,410,B80,Sicilian Defense: Scheveningen Variation
1689,1616,87,resign,white,73,B84,Sicilian Defense: Scheveningen Variation |  Classical Variation
1551,1440,65,mate,white,111,B84,Sicilian Defense: Scheveningen Variation |  Classical Variation
1816,1409,67,resign,white,407,B81,Sicilian Defense: Scheveningen Variation |  Keres Attack
1734,1727,91,time,white,7,B82,Sicilian Defense: Scheveningen Variation |  Matanovic Attack
1428,1666,47,mate,white,238,B80,Sicilian Defense: Scheveningen Variation |  Vitolins Variation
1800,1590,35,resign,white,210,B21,Sicilian Defense: Smith-Morra Gambit
1859,1460,35,resign,white,399,B21,Sicilian Defense: Smith-Morra Gambit
1854,1893,57,resign,white,39,B21,Sicilian Defense: Smith-Morra Gambit
1809,1792,29,resign,white,17,B21,Sicilian Defense: Smith-Morra Gambit
1663,1826,69,resign,white,163,B21,Sicilian Defense: Smith-Morra Gambit
1913,1504,71,resign,white,409,B21,Sicilian Defense: Smith-Morra Gambit
1858,1837,22,resign,white,21,B21,Sicilian Defense: Smith-Morra Gambit
1884,1870,73,time,white,14,B21,Sicilian Defense: Smith-Morra Gambit
1429,1389,27,resign,white,40,B21,Sicilian Defense: Smith-Morra Gambit
1224,1332,23,resign,white,108,B21,Sicilian Defense: Smith-Morra Gambit #2
1672,1701,59,resign,white,29,B21,Sicilian Defense: Smith-Morra Gambit #2
1331,1083,15,mate,white,248,B21,Sicilian Defense: Smith-Morra Gambit #2
1805,1870,45,resign,white,65,B21,Sicilian Defense: Smith-Morra Gambit #2
1400,1529,57,resign,white,129,B21,Sicilian Defense: Smith-Morra Gambit #2
1500,1238,71,time,white,262,B21,Sicilian Defense: Smith-Morra Gambit #2
1288,1268,53,resign,white,20,B21,Sicilian Defense: Smith-Morra Gambit #2
1469,1453,39,mate,white,16,B21,Sicilian Defense: Smith-Morra Gambit #2
1435,1523,75,resign,white,88,B21,Sicilian Defense: Smith-Morra Gambit #2
1076,1343,39,mate,white,267,B21,Sicilian Defense: Smith-Morra Gambit #2
1477,1364,41,mate,white,113,B21,Sicilian Defense: Smith-Morra Gambit #2
1560,1661,83,time,white,101,B21,Sicilian Defense: Smith-Morra Gambit #2
1322,1147,27,resign,white,175,B21,Sicilian Defense: Smith-Morra Gambit #2
1325,1262,37,mate,white,63,B21,Sicilian Defense: Smith-Morra Gambit #2
1540,1446,40,resign,white,94,B21,Sicilian Defense: Smith-Morra Gambit #2
1034,1144,83,mate,white,110,B21,Sicilian Defense: Smith-Morra Gambit #2
1831,1765,93,resign,white,66,B21,Sicilian Defense: Smith-Morra Gambit #2
1869,1254,77,mate,white,615,B21,Sicilian Defense: Smith-Morra Gambit #2
1483,1270,34,resign,white,213,B21,Sicilian Defense: Smith-Morra Gambit #2
1413,1263,43,mate,white,150,B21,Sicilian Defense: Smith-Morra Gambit #2
1343,1061,15,resign,white,282,B21,Sicilian Defense: Smith-Morra Gambit #2
1581,1581,53,mate,white,0,B21,Sicilian Defense: Smith-Morra Gambit #2
1614,1613,73,mate,white,1,B21,Sicilian Defense: Smith-Morra Gambit #2
1568,1517,69,resign,white,51,B21,Sicilian Defense: Smith-Morra Gambit #2
1516,1598,53,resign,white,82,B21,Sicilian Defense: Smith-Morra Gambit #2
2228,1526,27,resign,white,702,B21,Sicilian Defense: Smith-Morra Gambit #2
1211,1264,37,mate,white,53,B21,Sicilian Defense: Smith-Morra Gambit #2
1879,1441,103,resign,white,438,B21,Sicilian Defense: Smith-Morra Gambit #2
1443,1410,31,mate,white,33,B21,Sicilian Defense: Smith-Morra Gambit #2
1667,1361,29,resign,white,306,B21,Sicilian Defense: Smith-Morra Gambit #2
1527,1341,49,mate,white,186,B21,Sicilian Defense: Smith-Morra Gambit #2
1550,1567,57,resign,white,17,B21,Sicilian Defense: Smith-Morra Gambit Declined |  Push Variation
1471,1576,69,mate,white,105,B20,Sicilian Defense: Snyder Variation
2069,1969,77,resign,white,100,B86,Sicilian Defense: Sozin Attack
1692,1682,81,resign,white,10,B57,Sicilian Defense: Sozin |  not Scheveningen
1484,898,49,mate,white,586,B20,Sicilian Defense: Staunton-Cochrane Variation
1540,2025,71,mate,white,485,B20,Sicilian Defense: Staunton-Cochrane Variation
1837,1743,44,resign,white,94,B20,Sicilian Defense: Staunton-Cochrane Variation
1559,1615,23,mate,white,56,B20,Sicilian Defense: Staunton-Cochrane Variation
1635,1574,100,resign,white,61,B20,Sicilian Defense: Staunton-Cochrane Variation
1200,958,24,resign,white,242,B20,Sicilian Defense: Staunton-Cochrane Variation
1114,1286,39,resign,white,172,B20,Sicilian Defense: Staunton-Cochrane Variation
1832,1773,125,time,white,59,B20,Sicilian Defense: Staunton-Cochrane Variation
1295,1427,69,mate,white,132,B20,Sicilian Defense: Staunton-Cochrane Variation
1230,1246,30,resign,white,16,B20,Sicilian Defense: Staunton-Cochrane Variation
2024,2031,65,resign,white,7,B20,Sicilian Defense: Staunton-Cochrane Variation
1832,1877,155,mate,white,45,B20,Sicilian Defense: Wing Gambit
1841,1847,65,time,white,6,B20,Sicilian Defense: Wing Gambit
2247,2094,41,mate,white,153,B20,Sicilian Defense: Wing Gambit |  Carlsbad Variation
2078,1351,21,resign,white,727,B20,Sicilian Defense: Wing Gambit |  Marshall Variation
2064,1986,31,resign,white,78,B20,Sicilian Defense: Wing Gambit |  Marshall Variation
1646,939,11,resign,white,707,D10,Slav Defense
1643,1696,45,resign,white,53,D10,Slav Defense
1747,1703,43,resign,white,44,D10,Slav Defense
1084,1370,73,resign,white,286,D10,Slav Defense
1692,1219,77,mate,white,473,D10,Slav Defense
1572,1276,39,resign,white,296,D10,Slav Defense
1500,1497,81,resign,white,3,D10,Slav Defense #2
1645,1645,49,resign,white,0,D10,Slav Defense #2
1710,1460,47,mate,white,250,D10,Slav Defense #2
1550,1763,79,time,white,213,D10,Slav Defense #2
1767,1424,39,mate,white,343,D10,Slav Defense #2
1725,1742,93,time,white,17,D10,Slav Defense #2
1783,1660,21,resign,white,123,D10,Slav Defense #2
1707,1637,85,resign,white,70,D10,Slav Defense #2
1139,1089,95,mate,white,50,D10,Slav Defense #3
1770,1247,51,resign,white,523,D10,Slav Defense #3
1791,1380,107,mate,white,411,D10,Slav Defense #3
1387,1399,35,resign,white,12,D10,Slav Defense: Exchange Variation
1806,1728,83,resign,white,78,D12,Slav Defense: Exchange Variation |  Schallopp Variation
1508,2203,41,mate,white,695,D14,Slav Defense: Exchange Variation |  Symmetrical Line
1850,1528,49,mate,white,322,D11,Slav Defense: Modern
1527,1381,65,resign,white,146,D11,Slav Defense: Modern Line
2109,1659,31,resign,white,450,D11,Slav Defense: Modern Line
1683,1708,85,resign,white,25,D11,Slav Defense: Modern Line
2215,2191,125,resign,white,24,D12,Slav Defense: Quiet Variation |  Pin Defense
2193,1799,53,resign,white,394,D12,Slav Defense: Quiet Variation |  Pin Defense
1822,1851,39,resign,white,29,D12,Slav Defense: Quiet Variation |  Schallopp Defense
1759,1814,65,resign,white,55,D12,Slav Defense: Quiet Variation |  Schallopp Defense
1578,1787,29,mate,white,209,D10,Slav Defense: Slav Gambit |  Alekhine Attack
1582,1494,43,resign,white,88,D15,Slav Defense: Three Knights Variation
1700,1625,35,resign,white,75,D15,Slav Defense: Three Knights Variation
1292,1275,32,resign,white,17,D15,Slav Defense: Three Knights Variation
1938,1831,63,resign,white,107,D15,Slav Defense: Three Knights Variation
1613,1535,35,resign,white,78,D15,Slav Defense: Three Knights Variation
1820,1621,61,resign,white,199,D15,Slav Defense: Three Knights Variation
1854,1502,93,resign,white,352,D15,Slav Defense: Three Knights Variation
1857,1519,34,resign,white,338,D15,Slav Defense: Three Knights Variation
1697,1592,73,resign,white,105,B00,St. George Defense
1302,1377,19,mate,white,75,B00,St. George Defense
1689,1135,7,mate,white,554,B00,St. George Defense
1686,1139,7,mate,white,547,B00,St. George Defense
1693,1144,7,mate,white,549,B00,St. George Defense
1690,1149,7,mate,white,541,B00,St. George Defense
1737,1154,7,mate,white,583,B00,St. George Defense
1630,1161,7,mate,white,469,B00,St. George Defense
1292,1250,83,resign,white,42,B00,St. George Defense
1234,1087,107,resign,white,147,B00,St. George Defense: Woodchuck Variation
1162,1273,67,resign,white,111,D32,Tarrasch Defense
1549,1551,85,resign,white,2,D32,Tarrasch Defense
1250,1244,52,resign,white,6,D32,Tarrasch Defense
1689,1593,32,resign,white,96,D32,Tarrasch Defense: Symmetrical Variation
1877,1781,55,resign,white,96,D32,Tarrasch Defense: Symmetrical Variation
2101,1741,46,resign,white,360,D32,Tarrasch Defense: Two Knights Variation
914,1133,45,mate,white,219,C46,Three Knights Opening
1491,1438,53,mate,white,53,C46,Three Knights Opening
1648,1672,103,mate,white,24,C46,Three Knights Opening
1660,1665,25,resign,white,5,C46,Three Knights Opening
1651,1573,123,time,white,78,C46,Three Knights Opening
1245,1300,51,mate,white,55,C46,Three Knights Opening
1638,1408,61,resign,white,230,C46,Three Knights Opening
1618,1630,45,resign,white,12,C46,Three Knights Opening
1584,1500,19,resign,white,84,C46,Three Knights Opening
1647,1531,95,resign,white,116,C46,Three Knights Opening
1707,1858,29,resign,white,151,C46,Three Knights Opening
1441,1442,13,resign,white,1,C46,Three Knights Opening
1746,1744,89,mate,white,2,C46,Three Knights Opening
1333,1272,62,resign,white,61,C46,Three Knights Opening
1745,1598,59,mate,white,147,C46,Three Knights Opening
967,1491,49,mate,white,524,C46,Three Knights Opening
1322,1340,58,resign,white,18,C46,Three Knights Opening
2177,2024,89,mate,white,153,C46,Three Knights Opening
1418,1302,12,resign,white,116,C46,Three Knights Opening
1764,1544,73,mate,white,220,C46,Three Knights Opening #2
1764,1404,41,resign,white,360,C46,Three Knights Opening: Schlechter Variation
1602,1523,27,resign,white,79,A48,Torre Attack
2179,2154,71,resign,white,25,A48,Torre Attack
2148,2274,39,resign,white,126,A48,Torre Attack
1500,1973,41,time,white,473,A46,Torre Attack
1383,1330,121,resign,white,53,A46,Torre Attack #2
1212,1175,35,time,white,37,A46,Torre Attack #2
1536,1962,57,resign,white,426,A45,Trompowsky Attack
2460,2240,71,resign,white,220,A45,Trompowsky Attack
1833,1873,35,resign,white,40,A45,Trompowsky Attack
2016,2032,103,resign,white,16,A45,Trompowsky Attack
1547,1493,87,resign,white,54,A45,Trompowsky Attack
1579,1722,111,mate,white,143,A45,Trompowsky Attack: Classical Defense
1789,1843,53,resign,white,54,A45,Trompowsky Attack: Classical Defense |  Big Center Variation
1479,1407,61,mate,white,72,A45,Trompowsky Attack: Classical Defense |  Big Center Variation
2116,2029,45,resign,white,87,A45,Trompowsky Attack: Classical Defense |  Big Center Variation
1687,1487,93,resign,white,200,A00,Van Geet Opening
1253,1917,99,resign,white,664,A00,Van Geet Opening: Dunst-Perrenet Gambit
1733,1504,21,resign,white,229,A00,Van Geet Opening: Dunst-Perrenet Gambit
1302,1724,87,resign,white,422,A00,Van Geet Opening: Napoleon Attack
1417,921,40,resign,white,496,A00,Van Geet Opening: Reversed Nimzowitsch
1304,1292,39,mate,white,12,A00,Van't Kruijs Opening
1361,1383,24,resign,white,22,A00,Van't Kruijs Opening
1238,985,11,mate,white,253,A00,Van't Kruijs Opening
1710,1618,103,time,white,92,A00,Van't Kruijs Opening
1894,1539,5,mate,white,355,A00,Van't Kruijs Opening
1185,1222,57,resign,white,37,A00,Van't Kruijs Opening
1374,1408,13,resign,white,34,A00,Van't Kruijs Opening
808,973,47,mate,white,165,A00,Van't Kruijs Opening
1347,1268,71,mate,white,79,A00,Van't Kruijs Opening
2033,1256,35,resign,white,777,A00,Van't Kruijs Opening
1477,1560,76,resign,white,83,A00,Van't Kruijs Opening
1261,1045,69,resign,white,216,A00,Van't Kruijs Opening
1273,1129,49,resign,white,144,A00,Van't Kruijs Opening
1142,1061,33,mate,white,81,A00,Van't Kruijs Opening
1319,1096,9,resign,white,223,A00,Van't Kruijs Opening
1325,1500,18,resign,white,175,A00,Van't Kruijs Opening
1443,1291,9,resign,white,152,A00,Van't Kruijs Opening
1527,1329,117,mate,white,198,A00,Van't Kruijs Opening
1209,1337,63,time,white,128,A00,Van't Kruijs Opening
1740,1812,48,resign,white,72,A00,Van't Kruijs Opening
1337,1662,137,resign,white,325,A00,Van't Kruijs Opening
1329,1494,41,mate,white,165,A00,Van't Kruijs Opening
1432,1298,57,mate,white,134,A00,Van't Kruijs Opening
1286,1225,7,resign,white,61,A00,Van't Kruijs Opening
1408,1432,53,mate,white,24,A00,Van't Kruijs Opening
1233,1174,29,mate,white,59,C27,Vienna Game
1398,1312,27,mate,white,86,C27,Vienna Game
1239,1699,109,time,white,460,C27,Vienna Game
1046,986,5,time,white,60,C27,Vienna Game
1567,1473,115,mate,white,94,C27,Vienna Game
1857,1537,93,mate,white,320,C27,Vienna Game
1759,1790,63,mate,white,31,C25,Vienna Game: Anderssen Defense
1379,1431,37,resign,white,52,C25,Vienna Game: Anderssen Defense
1242,1125,105,resign,white,117,C26,Vienna Game: Falkbeer Variation
1192,1153,125,time,white,39,C26,Vienna Game: Falkbeer Variation
1254,1245,57,mate,white,9,C26,Vienna Game: Falkbeer Variation
1191,1269,99,mate,white,78,C25,Vienna Game: Max Lange Defense
1895,2028,119,time,white,133,C25,Vienna Game: Max Lange Defense
1492,1458,28,resign,white,34,C26,Vienna Game: Mengarini Variation
1535,1634,103,mate,white,99,C25,Vienna Game: Paulsen Variation
1500,1509,53,mate,white,9,C26,Vienna Game: Stanley Variation
1586,1383,111,mate,white,203,C26,Vienna Game: Stanley Variation
1055,1034,45,resign,white,21,C26,Vienna Game: Stanley Variation
1657,1544,39,mate,white,113,C26,Vienna Game: Stanley Variation
1533,1398,67,resign,white,135,C26,Vienna Game: Stanley Variation
1324,1096,49,mate,white,228,C26,Vienna Game: Stanley Variation |  Reversed Spanish
1423,1402,99,time,white,21,C26,Vienna Game: Stanley Variation |  Reversed Spanish
1186,1223,35,resign,white,37,C28,Vienna Game: Vienna Gambit
1298,1369,101,mate,white,71,C28,Vienna Game: Vienna Gambit
1651,1087,79,mate,white,564,C29,Vienna Game: Vienna Gambit |  Main Line
1094,1144,81,mate,white,50,C25,Vienna Game: Zhuravlev Countergambit #2
1780,1722,73,mate,white,58,A41,Wade Defense
1564,1510,73,resign,white,54,B00,Ware Defense
2349,1750,23,resign,white,599,A00,Ware Opening
1730,1500,79,mate,white,230,A00,Ware Opening
1569,1284,75,resign,white,285,A00,Ware Opening
1865,1862,111,resign,white,3,A46,Yusupov-Rubinstein System
1500,2154,35,mate,white,654,A46,Yusupov-Rubinstein System
1817,2085,113,resign,white,268,A46,Yusupov-Rubinstein System
1514,1672,40,resign,white,158,A46,Yusupov-Rubinstein System
1409,1507,55,mate,white,98,A46,Yusupov-Rubinstein System
1194,1449,63,mate,white,255,A46,Yusupov-Rubinstein System
1589,1635,80,resign,white,46,A46,Yusupov-Rubinstein System
1693,1386,47,mate,white,307,A04,Zukertort Opening
1634,1500,19,mate,white,134,A04,Zukertort Opening: Arctic Defense
1951,1862,39,resign,white,89,A04,Zukertort Opening: Black Mustang Defense
1687,1624,57,resign,white,63,A04,Zukertort Opening: Black Mustang Defense
1772,1554,15,resign,white,218,A04,Zukertort Opening: Black Mustang Defense
1978,2004,11,time,white,26,A04,Zukertort Opening: Black Mustang Defense
1645,1334,17,mate,white,311,A04,Zukertort Opening: Black Mustang Defense
1500,1260,41,mate,white,240,A04,Zukertort Opening: Black Mustang Defense
1494,1116,45,resign,white,378,A49,Zukertort Opening: Double Fianchetto Attack
1044,1080,141,time,white,36,A04,Zukertort Opening: Dutch Variation
2026,1864,46,resign,white,162,A04,Zukertort Opening: Dutch Variation
2021,1806,55,resign,white,215,A04,Zukertort Opening: Dutch Variation
1755,1574,39,resign,white,181,A04,Zukertort Opening: Kingside Fianchetto
1958,1952,113,time,white,6,A04,Zukertort Opening: Kingside Fianchetto
1960,2000,53,resign,white,40,A04,Zukertort Opening: Kingside Fianchetto
1099,1124,52,resign,white,25,A04,Zukertort Opening: Kingside Fianchetto
1746,1743,95,mate,white,3,A04,Zukertort Opening: Kingside Fianchetto
1862,1935,71,resign,white,73,A04,Zukertort Opening: Lisitsyn Gambit
1903,1887,73,resign,white,16,A04,Zukertort Opening: Pirc Invitation
1672,1702,38,resign,white,30,A04,Zukertort Opening: Pirc Invitation
1306,1124,43,resign,white,182,A04,Zukertort Opening: Pirc Invitation
2023,1671,33,mate,white,352,A04,Zukertort Opening: Queen's Gambit Invitation
1990,1678,53,mate,white,312,A04,Zukertort Opening: Queen's Gambit Invitation
1694,1305,73,mate,white,389,A04,Zukertort Opening: Queen's Gambit Invitation
1930,1810,21,resign,white,120,A04,Zukertort Opening: Queen's Gambit Invitation
1722,1756,44,resign,white,34,A04,Zukertort Opening: Queen's Gambit Invitation
1694,1305,73,mate,white,389,A04,Zukertort Opening: Queen's Gambit Invitation
1684,1560,89,mate,white,124,A04,Zukertort Opening: Queen's Gambit Invitation
1885,1798,73,mate,white,87,A04,Zukertort Opening: Queen's Gambit Invitation
1859,1741,75,mate,white,118,A04,Zukertort Opening: Queen's Gambit Invitation
2351,2097,47,resign,white,254,A04,Zukertort Opening: Queen's Gambit Invitation
2241,1923,89,mate,white,318,A04,Zukertort Opening: Queen's Gambit Invitation
1493,1585,83,mate,white,92,A04,Zukertort Opening: Queen's Gambit Invitation
1383,1384,57,resign,white,1,A04,Zukertort Opening: Queenside Fianchetto Variation
1266,1053,53,resign,white,213,A04,Zukertort Opening: Queenside Fianchetto Variation
1956,1854,77,resign,white,102,A04,Zukertort Opening: Queenside Fianchetto Variation
1633,1106,66,resign,white,527,A04,Zukertort Opening: Queenside Fianchetto Variation
2040,1983,159,resign,white,57,A04,Zukertort Opening: Queenside Fianchetto Variation
1676,1457,154,resign,white,219,A04,Zukertort Opening: Queenside Fianchetto Variation
1100,1306,71,mate,white,206,A04,Zukertort Opening: Quiet System
1330,1409,35,resign,white,79,A06,Zukertort Opening: Reversed Mexican Defense
1087,1233,81,mate,white,146,A06,Zukertort Opening: Reversed Mexican Defense
1453,1482,118,resign,white,29,A06,Zukertort Opening: Reversed Mexican Defense
1521,1162,8,resign,white,359,A04,Zukertort Opening: Ross Gambit
1787,1343,5,resign,white,444,A04,Zukertort Opening: Ross Gambit
1323,1263,77,resign,white,60,A04,Zukertort Opening: Ross Gambit
1527,1507,23,resign,white,20,A04,Zukertort Opening: Ross Gambit
1872,1918,39,time,white,46,A04,Zukertort Opening: Ross Gambit
1879,1569,51,resign,white,310,A06,Zukertort Opening: Santasiere's Folly
1774,1768,43,resign,white,6,A04,Zukertort Opening: Sicilian Invitation
1301,1401,129,time,white,100,A04,Zukertort Opening: Sicilian Invitation
2008,1986,145,resign,white,22,A04,Zukertort Opening: Sicilian Invitation
1958,1996,17,resign,white,38,A04,Zukertort Opening: Sicilian Invitation
1620,890,23,resign,white,730,A04,Zukertort Opening: Sicilian Invitation
1680,1600,97,mate,white,80,A04,Zukertort Opening: Sicilian Invitation
1967,1500,28,resign,white,467,A04,Zukertort Opening: Slav Invitation
1792,1898,29,resign,white,106,A04,Zukertort Opening: Slav Invitation
1225,1014,45,resign,white,211,A06,Zukertort Opening: Tennison Gambit
1720,1905,47,resign,white,185,A06,Zukertort Opening: Tennison Gambit
1495,1263,19,mate,white,232,A06,Zukertort Opening: Tennison Gambit
1901,1924,61,resign,white,23,A06,Zukertort Opening: Tennison Gambit
1889,1938,59,resign,white,49,A06,Zukertort Opening: Tennison Gambit
1855,1912,97,resign,white,57,A06,Zukertort Opening: Tennison Gambit
1869,1960,65,resign,white,91,A06,Zukertort Opening: Tennison Gambit
1842,1958,155,resign,white,116,A06,Zukertort Opening: Tennison Gambit
2113,1692,57,resign,white,421,A06,Zukertort Opening: Tennison Gambit
